Chart/1,source_org_jfree_chart_renderer_category_AbstractCategoryItemRenderer,1020,80,1064,44,0,0,82,2,0,0,1063,43,0,1,82,2,0,0
Chart/10,source_org_jfree_chart_imagemap_StandardToolTipTagFragmentGenerator,4,1,15,11,0,0,3,2,0,0,13,9,0,2,3,2,0,0
Chart/11,source_org_jfree_chart_util_ShapeUtilities,337,21,379,42,0,0,23,2,0,0,375,38,0,4,23,2,0,0
Chart/12,source_org_jfree_chart_plot_MultiplePiePlot,302,28,326,24,0,0,30,2,0,0,325,23,0,1,30,2,0,0
Chart/13,source_org_jfree_chart_block_BorderArrangement,284,15,345,61,0,0,17,2,0,0,341,57,0,4,17,2,0,0
Chart/14,source_org_jfree_chart_plot_CategoryPlot,2226,217,2277,51,0,0,220,3,0,0,2269,43,0,8,220,3,0,0
Chart/14,source_org_jfree_chart_plot_XYPlot,2779,252,2830,51,0,0,255,3,0,0,2822,43,0,8,255,3,0,0
Chart/15,source_org_jfree_chart_plot_PiePlot,1443,170,1477,34,0,0,173,3,0,0,1471,28,0,6,173,3,0,0
Chart/16,source_org_jfree_data_category_DefaultIntervalCategoryDataset,343,34,412,69,0,0,37,3,0,0,403,60,0,9,37,3,0,0
Chart/17,source_org_jfree_data_time_TimeSeries,543,52,557,14,0,0,54,2,0,0,553,10,0,4,54,2,0,0
Chart/18,source_org_jfree_data_DefaultKeyedValues,224,24,248,24,0,0,27,3,0,0,245,21,0,3,27,3,0,0
Chart/18,source_org_jfree_data_DefaultKeyedValues2D,270,27,288,18,0,0,29,2,0,0,287,17,0,1,29,2,0,0
Chart/19,source_org_jfree_chart_plot_CategoryPlot,2099,203,2129,30,0,0,206,3,0,0,2127,28,0,2,206,3,0,0
Chart/2,source_org_jfree_data_general_DatasetUtilities,1308,50,1418,110,0,0,53,3,0,0,1409,101,2,9,53,3,0,0
Chart/20,source_org_jfree_chart_plot_ValueMarker,44,6,61,17,0,0,8,2,0,0,52,8,0,9,8,2,0,0
Chart/21,source_org_jfree_data_statistics_DefaultBoxAndWhiskerCategoryDataset,340,44,396,56,0,0,47,3,0,0,392,52,1,4,47,3,0,0
Chart/22,source_org_jfree_data_KeyedObjects2D,183,21,259,76,0,0,26,5,0,0,248,65,2,11,26,5,0,0
Chart/23,source_org_jfree_chart_renderer_category_MinMaxCategoryRenderer,272,34,276,4,0,0,35,1,0,0,276,4,0,0,35,1,0,0
Chart/24,source_org_jfree_chart_renderer_GrayPaintScale,49,8,65,16,0,0,10,2,0,0,61,12,0,4,10,2,0,0
Chart/25,source_org_jfree_chart_renderer_category_StatisticalBarRenderer,93,12,297,204,0,0,15,3,0,0,271,178,6,26,15,3,0,0
Chart/26,source_org_jfree_chart_axis_Axis,567,98,653,86,0,0,100,2,0,0,644,77,1,9,100,2,0,0
Chart/3,source_org_jfree_data_time_TimeSeries,687,64,720,33,0,0,66,2,0,0,716,29,0,4,66,2,0,0
Chart/4,source_org_jfree_chart_plot_XYPlot,3198,290,3287,89,0,0,292,2,0,0,3283,85,2,4,292,2,0,0
Chart/5,source_org_jfree_data_xy_XYSeries,346,38,385,39,0,0,40,2,0,0,380,34,1,5,40,2,0,0
Chart/6,source_org_jfree_chart_util_ShapeList,61,7,77,16,0,0,9,2,0,0,75,14,0,2,9,2,0,0
Chart/7,source_org_jfree_data_time_TimePeriodValues,229,38,297,68,0,0,40,2,0,0,295,66,0,2,40,2,0,0
Chart/8,source_org_jfree_data_time_Week,303,31,314,11,0,0,33,2,0,0,312,9,0,2,33,2,0,0
Chart/9,source_org_jfree_data_time_TimeSeries,512,52,558,46,0,0,54,2,0,0,552,40,0,6,54,2,0,0
Cli/1,src_java_org_apache_commons_cli_CommandLine,65,12,121,56,0,4,20,8,0,0,104,39,0,21,20,8,0,0
Cli/10,src_java_org_apache_commons_cli_Parser,193,14,206,13,0,0,16,2,0,0,203,10,0,3,16,2,0,0
Cli/11,src_java_org_apache_commons_cli_HelpFormatter,434,55,461,27,0,0,57,2,0,0,458,24,0,3,57,2,0,0
Cli/12,src_java_org_apache_commons_cli_GnuParser,0,0,45,45,0,0,2,2,0,0,41,41,0,4,2,2,0,0
Cli/13,src_java_org_apache_commons_cli2_WriteableCommandLine,27,7,31,4,0,0,8,1,0,0,31,4,0,0,8,1,0,0
Cli/13,src_java_org_apache_commons_cli2_commandline_WriteableCommandLineImpl,173,27,178,5,0,0,28,1,0,0,178,5,0,0,28,1,0,0
Cli/13,src_java_org_apache_commons_cli2_option_ArgumentImpl,211,37,254,43,0,1,39,2,0,0,250,39,0,5,39,2,0,0
Cli/14,src_java_org_apache_commons_cli2_option_GroupImpl,307,30,343,36,0,1,32,2,0,0,341,34,0,3,32,2,0,0
Cli/15,src_java_org_apache_commons_cli2_commandline_WriteableCommandLineImpl,200,30,224,24,0,0,32,2,0,0,213,13,1,11,32,2,0,0
Cli/16,src_java_org_apache_commons_cli2_Option,45,14,48,3,0,0,15,1,0,0,48,3,0,0,15,1,0,0
Cli/16,src_java_org_apache_commons_cli2_commandline_WriteableCommandLineImpl,213,30,228,15,0,0,32,2,0,0,227,14,0,1,32,2,0,0
Cli/16,src_java_org_apache_commons_cli2_option_GroupImpl,306,30,344,38,0,0,32,2,0,0,339,33,0,5,32,2,0,0
Cli/16,src_java_org_apache_commons_cli2_option_OptionImpl,119,14,124,5,0,0,15,1,0,0,124,5,0,0,15,1,0,0
Cli/17,src_java_org_apache_commons_cli_PosixParser,97,10,124,27,0,0,12,2,0,0,121,24,1,3,12,2,0,0
Cli/18,src_java_org_apache_commons_cli_PosixParser,59,8,118,59,0,0,11,3,0,0,110,51,1,8,11,3,0,0
Cli/19,src_java_org_apache_commons_cli_PosixParser,100,9,118,18,0,0,11,2,0,0,115,15,0,3,11,2,0,0
Cli/2,src_java_org_apache_commons_cli_PosixParser,98,10,126,28,0,0,12,2,0,0,124,26,0,2,12,2,0,0
Cli/20,src_java_org_apache_commons_cli_PosixParser,72,9,114,42,5,8,11,2,0,0,109,37,2,13,11,2,0,0
Cli/21,src_java_org_apache_commons_cli2_WriteableCommandLine,35,9,39,4,0,0,10,1,0,0,39,4,0,0,10,1,0,0
Cli/21,src_java_org_apache_commons_cli2_commandline_WriteableCommandLineImpl,209,29,233,24,0,0,32,3,0,0,230,21,0,3,32,3,0,0
Cli/21,src_java_org_apache_commons_cli2_option_GroupImpl,341,31,353,12,0,0,33,2,0,0,351,10,0,2,33,2,0,0
Cli/22,src_java_org_apache_commons_cli_PosixParser,16,5,103,87,0,2,10,5,0,0,91,75,1,14,10,5,0,0
Cli/23,src_java_org_apache_commons_cli_HelpFormatter,431,55,460,29,0,2,57,2,0,0,453,22,0,9,57,2,0,0
Cli/24,src_java_org_apache_commons_cli_HelpFormatter,431,55,463,32,0,0,57,2,0,0,457,26,0,6,57,2,0,0
Cli/25,src_java_org_apache_commons_cli_HelpFormatter,431,55,465,34,0,0,57,2,0,0,457,26,0,8,57,2,0,0
Cli/26,src_java_org_apache_commons_cli_OptionBuilder,152,28,175,23,0,0,30,2,0,0,170,18,0,5,30,2,0,0
Cli/27,src_java_org_apache_commons_cli_OptionGroup,57,11,78,21,0,0,13,2,0,0,76,19,0,2,13,2,0,0
Cli/28,src_java_org_apache_commons_cli_Parser,170,14,201,31,0,0,16,2,0,0,199,29,0,2,16,2,0,0
Cli/29,src_java_org_apache_commons_cli_Util,15,1,30,15,0,0,3,2,0,0,27,12,0,3,3,2,0,0
Cli/3,src_java_org_apache_commons_cli_TypeHandler,117,8,137,20,0,0,10,2,0,0,132,15,0,5,10,2,0,0
Cli/30,src_main_java_org_apache_commons_cli_DefaultParser,339,29,370,31,0,0,31,2,0,0,368,29,0,2,31,2,0,0
Cli/30,src_main_java_org_apache_commons_cli_Parser,177,15,212,35,0,0,17,2,0,0,210,33,0,2,17,2,0,0
Cli/31,src_main_java_org_apache_commons_cli_HelpFormatter,452,59,480,28,0,0,61,2,0,0,477,25,0,3,61,2,0,0
Cli/31,src_main_java_org_apache_commons_cli_Option,315,56,320,5,0,0,58,2,0,0,320,5,0,0,58,2,0,0
Cli/31,src_main_java_org_apache_commons_cli_OptionBuilder,160,28,179,19,0,0,30,2,0,0,175,15,0,4,30,2,0,0
Cli/32,src_main_java_org_apache_commons_cli_HelpFormatter,445,59,472,27,0,0,61,2,0,0,469,24,0,3,61,2,0,0
Cli/33,src_main_java_org_apache_commons_cli_HelpFormatter,458,59,473,15,0,0,61,2,0,0,469,11,0,4,61,2,0,0
Cli/34,src_main_java_org_apache_commons_cli_Option,315,56,320,5,0,0,58,2,0,0,320,5,0,0,58,2,0,0
Cli/34,src_main_java_org_apache_commons_cli_OptionBuilder,160,28,179,19,0,0,30,2,0,0,175,15,0,4,30,2,0,0
Cli/35,src_main_java_org_apache_commons_cli_Options,125,20,142,17,0,0,22,2,0,0,140,15,0,2,22,2,0,0
Cli/36,src_main_java_org_apache_commons_cli_OptionGroup,75,11,81,6,0,0,13,2,0,0,80,5,0,1,13,2,0,0
Cli/36,src_main_java_org_apache_commons_cli_Options,141,20,146,5,0,0,22,2,0,0,146,5,0,0,22,2,0,0
Cli/37,src_main_java_org_apache_commons_cli_DefaultParser,363,29,375,12,1,5,31,2,0,0,371,8,5,9,31,2,0,0
Cli/38,src_main_java_org_apache_commons_cli_DefaultParser,363,29,377,14,3,2,31,2,0,0,376,13,0,3,31,2,0,0
Cli/39,src_main_java_org_apache_commons_cli_TypeHandler,87,8,128,41,0,0,10,2,0,0,122,35,0,6,10,2,0,0
Cli/4,src_java_org_apache_commons_cli_Parser,168,11,186,18,0,0,13,2,0,0,185,17,0,1,13,2,0,0
Cli/40,src_main_java_org_apache_commons_cli_TypeHandler,99,9,140,41,0,0,11,2,0,0,133,34,0,7,11,2,0,0
Cli/5,src_java_org_apache_commons_cli_Util,12,1,26,14,0,0,3,2,0,0,24,12,0,2,3,2,0,0
Cli/7,src_java_org_apache_commons_cli2_builder_PatternBuilder,129,10,134,5,0,0,12,2,0,0,133,4,0,1,12,2,0,0
Cli/8,src_java_org_apache_commons_cli_HelpFormatter,418,52,445,27,0,0,54,2,0,0,440,22,0,5,54,2,0,0
Cli/9,src_java_org_apache_commons_cli_Parser,184,14,205,21,0,0,16,2,0,0,204,20,0,1,16,2,0,0
Closure/1,src_com_google_javascript_jscomp_RemoveUnusedVars,562,57,592,30,0,0,59,2,0,0,591,29,0,1,59,2,0,0
Closure/10,src_com_google_javascript_jscomp_NodeUtil,2507,190,2523,16,0,0,192,2,0,0,2520,13,0,3,192,2,0,0
Closure/100,src_com_google_javascript_jscomp_CheckGlobalThis,39,7,86,47,0,0,10,3,0,0,79,40,0,7,10,3,0,0
Closure/101,src_com_google_javascript_jscomp_CommandLineRunner,153,50,175,22,0,2,52,2,0,0,173,20,0,4,52,2,0,0
Closure/102,src_com_google_javascript_jscomp_Normalize,365,35,384,19,0,0,37,2,0,0,381,16,0,3,37,2,0,0
Closure/103,src_com_google_javascript_jscomp_ControlFlowAnalysis,708,54,737,29,0,0,56,2,0,0,735,27,0,2,56,2,0,0
Closure/103,src_com_google_javascript_jscomp_DisambiguateProperties,769,94,801,32,0,0,97,3,0,0,796,27,0,5,97,3,0,0
Closure/104,src_com_google_javascript_rhino_jstype_UnionType,350,31,384,34,0,0,33,2,0,0,380,30,0,4,33,2,0,0
Closure/105,src_com_google_javascript_jscomp_FoldConstants,1430,57,1511,81,0,6,59,2,0,0,1502,72,0,15,59,2,0,0
Closure/106,src_com_google_javascript_jscomp_GlobalNamespace,699,84,714,15,0,0,87,3,0,0,713,14,0,1,87,3,0,0
Closure/106,src_com_google_javascript_rhino_JSDocInfoBuilder,522,54,533,11,0,0,56,2,0,0,531,9,0,2,56,2,0,0
Closure/107,src_com_google_javascript_jscomp_CommandLineRunner,359,101,404,45,0,0,103,2,0,0,402,43,0,2,103,2,0,0
Closure/108,src_com_google_javascript_jscomp_ScopedAliases,283,50,415,132,0,0,55,5,0,0,408,125,0,7,55,5,0,0
Closure/109,src_com_google_javascript_jscomp_parsing_JsDocInfoParser,1798,101,1807,9,0,2,103,2,0,0,1804,6,0,5,103,2,0,0
Closure/11,src_com_google_javascript_jscomp_TypeCheck,1111,87,1133,22,0,0,89,2,0,0,1130,19,0,3,89,2,0,0
Closure/110,src_com_google_javascript_jscomp_ScopedAliases,351,52,397,46,0,0,55,3,0,0,393,42,2,4,55,3,0,0
Closure/110,src_com_google_javascript_rhino_Node,2225,315,2246,21,0,0,317,2,0,0,2244,19,0,2,317,2,0,0
Closure/111,src_com_google_javascript_jscomp_type_ClosureReverseAbstractInterpreter,198,28,210,12,0,0,31,3,0,0,202,4,0,8,30,2,0,1
Closure/112,src_com_google_javascript_jscomp_TypeInference,1124,73,1145,21,0,0,75,2,0,0,1141,17,0,4,75,2,0,0
Closure/113,src_com_google_javascript_jscomp_ProcessClosurePrimitives,787,82,821,34,0,0,84,2,0,0,818,31,0,3,84,2,0,0
Closure/114,src_com_google_javascript_jscomp_NameAnalyzer,1234,125,1263,29,0,0,128,3,0,0,1259,25,0,4,128,3,0,0
Closure/115,src_com_google_javascript_jscomp_FunctionInjector,476,44,517,41,0,0,46,2,0,0,514,38,0,3,46,2,0,0
Closure/116,src_com_google_javascript_jscomp_FunctionInjector,476,44,517,41,0,0,46,2,0,0,514,38,0,3,46,2,0,0
Closure/117,src_com_google_javascript_jscomp_TypeValidator,471,58,513,42,0,0,60,2,0,0,510,39,0,3,60,2,0,0
Closure/118,src_com_google_javascript_jscomp_DisambiguateProperties,881,100,903,22,0,0,103,3,0,0,901,20,0,2,103,3,0,0
Closure/119,src_com_google_javascript_jscomp_GlobalNamespace,863,124,983,120,2,2,127,3,0,0,976,113,6,9,127,3,0,0
Closure/12,src_com_google_javascript_jscomp_MaybeReachingVariableUse,182,19,190,8,0,0,21,2,0,0,189,7,0,1,21,2,0,0
Closure/120,src_com_google_javascript_jscomp_ReferenceCollectingCallback,469,77,492,23,0,0,80,3,0,0,491,22,0,1,80,3,0,0
Closure/121,src_com_google_javascript_jscomp_InlineVariables,410,39,472,62,0,0,42,3,0,0,469,59,0,3,42,3,0,0
Closure/122,src_com_google_javascript_jscomp_parsing_IRFactory,1231,109,1243,12,2,0,111,2,0,0,1239,8,0,4,111,2,0,0
Closure/123,src_com_google_javascript_jscomp_CodeGenerator,513,43,1017,504,0,1,45,2,0,0,1015,502,0,3,45,2,0,0
Closure/124,src_com_google_javascript_jscomp_ExploitAssigns,127,5,145,18,0,0,7,2,0,0,143,16,0,2,7,2,0,0
Closure/125,src_com_google_javascript_jscomp_TypeCheck,1260,97,1286,26,0,0,99,2,0,0,1284,24,0,2,99,2,0,0
Closure/126,src_com_google_javascript_jscomp_MinimizeExitPoints,116,7,181,65,0,0,9,2,0,0,178,62,0,3,9,2,0,0
Closure/127,src_com_google_javascript_jscomp_UnreachableCodeElimination,111,13,148,37,0,0,16,3,0,0,146,35,0,2,16,3,0,0
Closure/128,src_com_google_javascript_jscomp_CodeGenerator,991,42,1009,18,0,0,44,2,0,0,1008,17,0,1,44,2,0,0
Closure/129,src_com_google_javascript_jscomp_PrepareAst,127,14,147,20,0,0,17,3,0,0,145,18,0,2,17,3,0,0
Closure/13,src_com_google_javascript_jscomp_PeepholeOptimizationsPass,139,26,163,24,0,0,28,2,0,0,162,23,0,1,28,2,0,0
Closure/130,src_com_google_javascript_jscomp_CollapseProperties,514,31,543,29,0,0,33,2,0,0,542,28,0,1,33,2,0,0
Closure/131,src_com_google_javascript_rhino_TokenStream,326,1,347,21,0,0,3,2,0,0,346,20,0,1,3,2,0,0
Closure/132,src_com_google_javascript_jscomp_PeepholeSubstituteAlternateSyntax,1024,61,1170,146,0,0,63,2,0,0,1168,144,0,2,63,2,0,0
Closure/133,src_com_google_javascript_jscomp_parsing_JsDocInfoParser,1691,91,1701,10,0,0,93,2,0,0,1699,8,0,2,93,2,0,0
Closure/134,src_com_google_javascript_jscomp_AmbiguateProperties,354,61,435,81,0,0,68,7,0,0,429,75,0,6,68,7,0,0
Closure/134,src_com_google_javascript_jscomp_TypedScopeCreator,798,56,818,20,0,0,59,3,0,0,814,16,0,4,59,3,0,0
Closure/135,src_com_google_javascript_jscomp_DevirtualizePrototypeMethods,173,11,193,20,0,0,13,2,0,0,191,18,0,2,13,2,0,0
Closure/135,src_com_google_javascript_rhino_jstype_FunctionType,569,59,590,21,0,0,61,2,0,0,585,16,0,5,61,2,0,0
Closure/136,src_com_google_javascript_jscomp_MethodCompilerPass,146,19,162,16,0,0,21,2,0,0,159,13,0,3,21,2,0,0
Closure/136,src_com_google_javascript_jscomp_RenameVars,219,42,270,51,0,0,45,3,0,0,265,46,0,5,45,3,0,0
Closure/137,src_com_google_javascript_jscomp_MakeDeclaredNamesUnique,251,39,322,71,4,4,51,12,0,0,298,47,9,28,51,12,0,0
Closure/137,src_com_google_javascript_jscomp_NodeUtil,1491,120,1495,4,0,0,121,1,0,0,1494,3,0,1,121,1,0,0
Closure/137,src_com_google_javascript_jscomp_Normalize,384,40,402,18,0,0,42,2,0,0,399,15,0,3,42,2,0,0
Closure/138,src_com_google_javascript_jscomp_ClosureReverseAbstractInterpreter,165,28,192,27,0,0,30,2,0,0,185,20,2,7,30,2,0,0
Closure/138,src_com_google_javascript_jscomp_TypeInference,842,57,872,30,0,0,59,2,0,0,865,23,1,7,59,2,0,0
Closure/139,src_com_google_javascript_jscomp_Normalize,346,32,410,64,0,0,43,11,0,0,395,49,0,15,43,11,0,0
Closure/14,src_com_google_javascript_jscomp_ControlFlowAnalysis,707,58,784,77,0,0,60,2,0,0,779,72,0,5,60,2,0,0
Closure/140,src_com_google_javascript_jscomp_Compiler,1193,182,1233,40,0,0,186,4,0,0,1227,34,0,6,186,4,0,0
Closure/141,src_com_google_javascript_jscomp_NodeUtil,1478,120,1503,25,0,0,122,2,0,0,1500,22,0,3,122,2,0,0
Closure/141,src_com_google_javascript_jscomp_PureFunctionIdentifier,416,49,446,30,0,0,51,2,0,0,433,17,6,13,51,2,0,0
Closure/142,src_com_google_javascript_jscomp_CoalesceVariableNames,291,34,313,22,0,0,36,2,0,0,311,20,0,2,36,2,0,0
Closure/142,src_com_google_javascript_jscomp_parsing_JsDocInfoParser,1337,76,1408,71,0,0,78,2,0,0,1400,63,3,8,78,2,0,0
Closure/143,src_com_google_javascript_jscomp_AbstractCommandLineRunner,765,101,810,45,0,0,103,2,0,0,807,42,0,3,103,2,0,0
Closure/143,src_com_google_javascript_jscomp_RemoveConstantExpressions,61,13,83,22,0,0,16,3,0,0,79,18,0,4,16,3,0,0
Closure/144,src_com_google_javascript_jscomp_FunctionTypeBuilder,277,42,318,41,0,0,45,3,0,0,314,37,0,4,45,3,0,0
Closure/144,src_com_google_javascript_jscomp_TypedScopeCreator,847,70,918,71,0,0,73,3,0,0,912,65,0,6,73,3,0,0
Closure/144,src_com_google_javascript_rhino_jstype_FunctionBuilder,92,23,96,4,0,0,24,1,0,0,95,3,0,1,24,1,0,0
Closure/144,src_com_google_javascript_rhino_jstype_FunctionType,625,64,635,10,0,0,66,2,0,0,631,6,0,4,66,2,0,0
Closure/145,src_com_google_javascript_jscomp_CodeGenerator,805,33,813,8,0,0,35,2,0,0,812,7,0,1,35,2,0,0
Closure/146,src_com_google_javascript_rhino_jstype_JSType,581,96,602,21,0,0,98,2,0,0,600,19,0,2,98,2,0,0
Closure/147,src_com_google_javascript_jscomp_CheckGlobalThis,49,8,91,42,0,0,10,2,0,0,87,38,0,4,10,2,0,0
Closure/147,src_com_google_javascript_jscomp_RuntimeTypeCheck,233,23,270,37,0,0,28,5,0,0,267,34,0,3,28,5,0,0
Closure/148,src_com_google_javascript_jscomp_PeepholeFoldConstants,834,26,877,43,0,0,28,2,0,0,874,40,1,3,28,2,0,0
Closure/148,src_com_google_javascript_jscomp_SourceMap,63,23,261,198,5,9,39,16,0,0,170,107,7,100,37,14,0,2
Closure/149,src_com_google_javascript_jscomp_AbstractCommandLineRunner,870,114,946,76,0,0,118,4,0,0,938,68,0,8,118,4,0,0
Closure/149,src_com_google_javascript_jscomp_CommandLineRunner,167,56,189,22,0,0,58,2,0,0,187,20,0,2,58,2,0,0
Closure/149,src_com_google_javascript_jscomp_Compiler,1340,195,1357,17,0,2,197,2,0,0,1354,14,0,5,197,2,0,0
Closure/149,src_com_google_javascript_jscomp_CompilerOptions,342,178,348,6,0,0,180,2,0,0,348,6,0,0,180,2,0,0
Closure/15,src_com_google_javascript_jscomp_FlowSensitiveInlineVariables,282,31,308,26,0,0,34,3,0,0,287,5,0,21,33,2,0,1
Closure/150,src_com_google_javascript_jscomp_TypedScopeCreator,958,79,981,23,0,0,82,3,0,0,975,17,0,6,82,3,0,0
Closure/151,src_com_google_javascript_jscomp_CommandLineRunner,144,55,189,45,0,0,58,3,0,0,186,42,0,3,58,3,0,0
Closure/152,src_com_google_javascript_rhino_jstype_FunctionType,630,64,661,31,0,0,66,2,0,0,656,26,0,5,66,2,0,0
Closure/154,src_com_google_javascript_jscomp_TypeCheck,1029,82,1084,55,0,0,86,4,0,0,1078,49,0,6,86,4,0,0
Closure/154,src_com_google_javascript_jscomp_TypeValidator,463,52,482,19,0,0,56,4,0,0,477,14,0,5,56,4,0,0
Closure/155,src_com_google_javascript_jscomp_InlineVariables,348,36,433,85,0,0,40,4,0,0,429,81,0,4,40,4,0,0
Closure/155,src_com_google_javascript_jscomp_ReferenceCollectingCallback,377,65,399,22,0,0,67,2,0,0,395,18,0,4,67,2,0,0
Closure/155,src_com_google_javascript_jscomp_Scope,316,59,319,3,0,0,60,1,0,0,319,3,0,0,60,1,0,0
Closure/156,src_com_google_javascript_jscomp_CollapseProperties,372,26,494,122,0,0,32,6,0,0,485,113,1,9,32,6,0,0
Closure/157,src_com_google_javascript_jscomp_CodeGenerator,407,35,896,489,0,0,37,2,0,0,889,482,0,7,37,2,0,0
Closure/157,src_com_google_javascript_jscomp_RenamePrototypes,201,31,272,71,0,0,35,4,0,0,261,60,0,11,35,4,0,0
Closure/157,src_com_google_javascript_jscomp_parsing_IRFactory,1123,89,1143,20,2,1,92,3,0,0,1141,18,2,3,92,3,0,0
Closure/158,src_com_google_javascript_jscomp_AbstractCommandLineRunner,979,130,1038,59,1,8,133,3,0,0,1034,55,0,12,133,3,0,0
Closure/158,src_com_google_javascript_jscomp_CommandLineRunner,176,59,237,61,3,2,66,7,0,0,230,54,3,9,66,7,0,0
Closure/158,src_com_google_javascript_jscomp_DiagnosticGroups,40,29,52,12,0,0,31,2,0,0,49,9,0,3,31,2,0,0
Closure/159,src_com_google_javascript_jscomp_InlineFunctions,847,122,866,19,0,0,124,2,0,0,860,13,4,6,124,2,0,0
Closure/16,src_com_google_javascript_jscomp_ScopedAliases,296,46,342,46,0,0,52,6,0,0,338,42,0,4,52,6,0,0
Closure/160,src_com_google_javascript_jscomp_Compiler,1442,204,1478,36,1,8,206,2,0,0,1476,34,0,10,206,2,0,0
Closure/161,src_com_google_javascript_jscomp_PeepholeFoldConstants,1049,36,1089,40,0,0,38,2,0,0,1085,36,0,4,38,2,0,0
Closure/164,src_com_google_javascript_rhino_jstype_ArrowType,141,17,182,41,0,0,19,2,0,0,179,38,0,3,19,2,0,0
Closure/165,src_com_google_javascript_rhino_jstype_JSTypeRegistry,953,104,972,19,0,0,106,2,0,0,970,17,0,2,106,2,0,0
Closure/165,src_com_google_javascript_rhino_jstype_ObjectType,448,75,453,5,0,0,76,1,0,0,453,5,0,0,76,1,0,0
Closure/165,src_com_google_javascript_rhino_jstype_RecordType,81,9,159,78,0,0,13,4,0,0,143,62,0,16,13,4,0,0
Closure/165,src_com_google_javascript_rhino_jstype_RecordTypeBuilder,37,11,48,11,0,0,13,2,0,0,47,10,0,1,13,2,0,0
Closure/166,src_com_google_javascript_rhino_jstype_PrototypeObjectType,457,49,472,15,0,0,51,2,0,0,470,13,0,2,51,2,0,0
Closure/167,src_com_google_javascript_jscomp_type_SemanticReverseAbstractInterpreter,364,32,490,126,0,0,38,6,0,0,453,89,0,37,38,6,0,0
Closure/167,src_com_google_javascript_rhino_jstype_JSType,801,123,817,16,0,0,125,2,0,0,815,14,0,2,125,2,0,0
Closure/168,src_com_google_javascript_jscomp_TypedScopeCreator,1233,100,1286,53,0,0,105,5,0,0,1280,47,0,6,105,5,0,0
Closure/169,src_com_google_javascript_rhino_jstype_ArrowType,172,18,213,41,0,0,21,3,0,0,206,34,0,7,21,3,0,0
Closure/169,src_com_google_javascript_rhino_jstype_FunctionType,823,82,883,60,0,0,86,4,0,0,876,53,0,7,86,4,0,0
Closure/169,src_com_google_javascript_rhino_jstype_JSType,821,125,908,87,0,0,130,5,0,0,896,75,3,12,130,5,0,0
Closure/169,src_com_google_javascript_rhino_jstype_RecordType,85,12,169,84,0,0,16,4,0,0,158,73,4,11,16,4,0,0
Closure/169,src_com_google_javascript_rhino_jstype_UnionType,486,40,520,34,0,0,43,3,0,0,514,28,0,6,43,3,0,0
Closure/17,src_com_google_javascript_jscomp_TypedScopeCreator,1217,102,1270,53,0,0,105,3,0,0,1264,47,0,6,105,3,0,0
Closure/170,src_com_google_javascript_jscomp_FlowSensitiveInlineVariables,300,32,327,27,1,1,36,4,0,0,318,18,0,10,35,3,0,1
Closure/171,src_com_google_javascript_jscomp_TypeInference,1090,73,1132,42,0,0,75,2,0,0,1129,39,0,3,75,2,0,0
Closure/171,src_com_google_javascript_jscomp_TypedScopeCreator,1321,106,1364,43,0,0,109,3,0,0,1358,37,0,6,109,3,0,0
Closure/172,src_com_google_javascript_jscomp_TypedScopeCreator,1322,106,1368,46,0,0,109,3,0,0,1362,40,0,6,109,3,0,0
Closure/173,src_com_google_javascript_jscomp_CodeGenerator,513,43,1013,500,0,0,45,2,0,0,1007,494,4,6,45,2,0,0
Closure/173,src_com_google_javascript_jscomp_PeepholeSubstituteAlternateSyntax,410,26,448,38,0,0,28,2,0,0,444,34,0,4,28,2,0,0
Closure/175,src_com_google_javascript_jscomp_FunctionInjector,447,43,502,55,1,0,46,3,0,0,489,42,8,13,46,3,0,0
Closure/18,src_com_google_javascript_jscomp_Compiler,1761,239,1849,88,0,0,241,2,0,0,1848,87,0,1,241,2,0,0
Closure/19,src_com_google_javascript_jscomp_type_ChainableReverseAbstractInterpreter,602,89,627,25,0,0,91,2,0,0,624,22,0,3,91,2,0,0
Closure/2,src_com_google_javascript_jscomp_TypeCheck,1158,91,1188,30,0,0,93,2,0,0,1182,24,0,6,93,2,0,0
Closure/20,src_com_google_javascript_jscomp_PeepholeSubstituteAlternateSyntax,1150,60,1171,21,0,0,62,2,0,0,1169,19,0,2,62,2,0,0
Closure/21,src_com_google_javascript_jscomp_CheckSideEffects,89,16,131,42,0,0,18,2,0,0,126,37,0,5,18,2,0,0
Closure/22,src_com_google_javascript_jscomp_CheckSideEffects,89,16,126,37,2,4,18,2,0,0,118,29,4,12,18,2,0,0
Closure/23,src_com_google_javascript_jscomp_PeepholeFoldConstants,1167,42,1212,45,0,1,44,2,0,0,1207,40,0,6,44,2,0,0
Closure/24,src_com_google_javascript_jscomp_ScopedAliases,268,45,296,28,0,0,48,3,0,0,293,25,4,3,48,3,0,0
Closure/25,src_com_google_javascript_jscomp_TypeInference,958,62,985,27,3,3,64,2,0,0,985,27,0,3,64,2,0,0
Closure/26,src_com_google_javascript_jscomp_ProcessCommonJSModules,160,25,188,28,0,0,29,4,0,0,185,25,0,3,29,4,0,0
Closure/27,src_com_google_javascript_rhino_IR,704,69,732,28,0,0,72,3,0,0,726,22,0,6,72,3,0,0
Closure/28,src_com_google_javascript_jscomp_InlineCostEstimator,58,16,65,7,0,0,18,2,0,0,64,6,0,1,18,2,0,0
Closure/29,src_com_google_javascript_jscomp_InlineObjectLiterals,206,15,258,52,0,0,18,3,0,0,257,51,0,1,18,3,0,0
Closure/3,src_com_google_javascript_jscomp_FlowSensitiveInlineVariables,222,31,324,102,0,0,36,5,0,0,322,100,0,2,36,5,0,0
Closure/30,src_com_google_javascript_jscomp_FlowSensitiveInlineVariables,292,32,306,14,0,0,34,2,0,0,303,11,0,3,34,2,0,0
Closure/30,src_com_google_javascript_jscomp_MustBeReachingVariableDef,269,25,311,42,0,0,30,5,0,0,297,28,0,14,29,4,0,1
Closure/31,src_com_google_javascript_jscomp_Compiler,1694,233,1800,106,0,0,235,2,0,0,1799,105,0,1,235,2,0,0
Closure/32,src_com_google_javascript_jscomp_parsing_JsDocInfoParser,1566,89,1637,71,0,0,91,2,0,0,1630,64,1,7,91,2,0,0
Closure/33,src_com_google_javascript_rhino_jstype_PrototypeObjectType,441,48,462,21,0,0,50,2,0,0,460,19,0,2,50,2,0,0
Closure/34,src_com_google_javascript_jscomp_CodeGenerator,448,37,959,511,1,2,40,3,0,0,949,501,0,12,40,3,0,0
Closure/34,src_com_google_javascript_jscomp_CodePrinter,444,80,466,22,0,0,83,3,0,0,462,18,0,4,83,3,0,0
Closure/35,src_com_google_javascript_jscomp_TypeInference,981,62,994,13,0,2,64,2,0,0,991,10,0,5,64,2,0,0
Closure/36,src_com_google_javascript_jscomp_InlineVariables,424,39,463,39,0,0,42,3,0,0,460,36,0,3,42,3,0,0
Closure/37,src_com_google_javascript_jscomp_NodeTraversal,505,70,532,27,0,0,72,2,0,0,530,25,0,2,72,2,0,0
Closure/37,src_com_google_javascript_jscomp_parsing_IRFactory,1048,96,1096,48,0,0,99,3,0,0,1093,45,0,3,99,3,0,0
Closure/38,src_com_google_javascript_jscomp_CodeConsumer,189,35,220,31,0,0,37,2,0,0,219,30,0,1,37,2,0,0
Closure/39,src_com_google_javascript_rhino_jstype_PrototypeObjectType,405,47,447,42,0,0,49,2,0,0,441,36,0,6,49,2,0,0
Closure/4,src_com_google_javascript_rhino_jstype_NamedType,242,33,271,29,0,0,35,2,0,0,267,25,0,4,35,2,0,0
Closure/40,src_com_google_javascript_jscomp_NameAnalyzer,1130,121,1187,57,0,0,124,3,0,0,1180,50,0,7,124,3,0,0
Closure/41,src_com_google_javascript_jscomp_FunctionTypeBuilder,456,77,551,95,0,0,80,3,0,0,544,88,0,7,80,3,0,0
Closure/42,src_com_google_javascript_jscomp_parsing_IRFactory,1081,96,1092,11,0,0,99,3,0,0,1089,8,0,3,99,3,0,0
Closure/43,src_com_google_javascript_jscomp_TypedScopeCreator,1151,100,1231,80,0,0,104,4,0,0,1224,73,0,7,104,4,0,0
Closure/44,src_com_google_javascript_jscomp_CodeConsumer,199,35,215,16,0,0,37,2,0,0,214,15,0,1,37,2,0,0
Closure/45,src_com_google_javascript_jscomp_RemoveUnusedVars,526,55,582,56,0,2,59,4,0,0,578,52,0,6,59,4,0,0
Closure/46,src_com_google_javascript_rhino_jstype_RecordType,156,12,159,3,0,0,13,1,0,0,159,3,0,0,13,1,0,0
Closure/47,src_com_google_debugging_sourcemap_SourceMapConsumerV3,545,76,566,21,0,0,78,2,0,0,561,16,0,5,78,2,0,0
Closure/47,src_com_google_javascript_jscomp_SourceMap,115,24,133,18,0,0,26,2,0,0,130,15,0,3,26,2,0,0
Closure/48,src_com_google_javascript_jscomp_TypedScopeCreator,1136,100,1213,77,1,2,103,3,0,0,1202,66,0,13,103,3,0,0
Closure/49,src_com_google_javascript_jscomp_MakeDeclaredNamesUnique,353,62,425,72,4,8,66,4,0,0,412,59,5,21,66,4,0,0
Closure/5,src_com_google_javascript_jscomp_InlineObjectLiterals,206,15,268,62,0,0,18,3,0,0,267,61,0,1,18,3,0,0
Closure/50,src_com_google_javascript_jscomp_PeepholeReplaceKnownMethods,381,14,475,94,0,0,16,2,0,0,473,92,0,2,16,2,0,0
Closure/51,src_com_google_javascript_jscomp_CodeConsumer,180,34,210,30,0,0,36,2,0,0,209,29,0,1,36,2,0,0
Closure/52,src_com_google_javascript_jscomp_CodeGenerator,921,39,937,16,0,0,41,2,0,0,936,15,0,1,41,2,0,0
Closure/53,src_com_google_javascript_jscomp_InlineObjectLiterals,205,15,254,49,0,0,18,3,0,0,248,43,3,6,18,3,0,0
Closure/54,src_com_google_javascript_jscomp_TypedScopeCreator,1047,90,1118,71,0,0,93,3,0,0,1112,65,0,6,93,3,0,0
Closure/54,src_com_google_javascript_rhino_jstype_FunctionType,708,71,754,46,0,0,74,3,0,0,750,42,0,4,74,3,0,0
Closure/55,src_com_google_javascript_jscomp_FunctionRewriter,339,53,350,11,0,0,55,2,0,0,349,10,0,1,55,2,0,0
Closure/56,src_com_google_javascript_jscomp_SourceFile,344,59,380,36,0,0,61,2,0,0,378,34,0,2,61,2,0,0
Closure/57,src_com_google_javascript_jscomp_ClosureCodingConvention,271,25,298,27,0,0,27,2,0,0,294,23,0,4,27,2,0,0
Closure/58,src_com_google_javascript_jscomp_LiveVariablesAnalysis,150,24,227,77,0,0,26,2,0,0,223,73,0,4,26,2,0,0
Closure/59,src_com_google_javascript_jscomp_Compiler,1471,207,1514,43,0,0,209,2,0,0,1513,42,0,1,209,2,0,0
Closure/6,src_com_google_javascript_jscomp_TypeValidator,471,57,507,36,0,0,60,3,0,0,494,23,2,13,60,3,0,0
Closure/60,src_com_google_javascript_jscomp_NodeUtil,2259,188,2335,76,0,0,191,3,0,0,2330,71,0,5,191,3,0,0
Closure/61,src_com_google_javascript_jscomp_NodeUtil,2286,189,2328,42,0,0,191,2,0,0,2325,39,0,3,191,2,0,0
Closure/62,src_com_google_javascript_jscomp_LightweightMessageFormatter,90,11,133,43,0,0,13,2,0,0,130,40,0,3,13,2,0,0
Closure/64,src_com_google_javascript_jscomp_Compiler,1411,201,1482,71,0,0,206,5,0,0,1468,57,0,14,205,4,0,1
Closure/65,src_com_google_javascript_jscomp_CodeGenerator,862,39,937,75,0,0,41,2,0,0,930,68,0,7,41,2,0,0
Closure/66,src_com_google_javascript_jscomp_TypeCheck,865,87,1149,284,0,0,89,2,0,0,1146,281,0,3,89,2,0,0
Closure/67,src_com_google_javascript_jscomp_AnalyzePrototypeProperties,451,84,475,24,0,0,87,3,0,0,474,23,0,1,87,3,0,0
Closure/68,src_com_google_javascript_jscomp_parsing_JsDocInfoParser,970,85,1603,633,0,0,89,4,0,0,1598,628,0,5,89,4,0,0
Closure/69,src_com_google_javascript_jscomp_TypeCheck,1111,87,1146,35,0,0,89,2,0,0,1144,33,0,2,89,2,0,0
Closure/7,src_com_google_javascript_jscomp_type_ChainableReverseAbstractInterpreter,609,88,637,28,0,0,91,3,0,0,630,21,0,7,91,3,0,0
Closure/70,src_com_google_javascript_jscomp_TypedScopeCreator,1147,91,1179,32,0,0,94,3,0,0,1174,27,0,5,94,3,0,0
Closure/71,src_com_google_javascript_jscomp_CheckAccessControls,335,39,392,57,0,0,41,2,0,0,389,54,0,3,41,2,0,0
Closure/72,src_com_google_javascript_jscomp_FunctionToBlockMutator,240,18,250,10,0,0,20,2,0,0,248,8,0,2,20,2,0,0
Closure/72,src_com_google_javascript_jscomp_RenameLabels,123,25,157,34,0,0,28,3,0,0,154,31,0,3,28,3,0,0
Closure/73,src_com_google_javascript_jscomp_CodeGenerator,851,37,926,75,0,0,39,2,0,0,919,68,0,7,39,2,0,0
Closure/74,src_com_google_javascript_jscomp_PeepholeFoldConstants,1173,42,1326,153,0,2,44,2,0,0,1317,144,0,11,44,2,0,0
Closure/75,src_com_google_javascript_jscomp_NodeUtil,2266,184,2315,49,3,3,187,3,0,0,2310,44,3,8,187,3,0,0
Closure/76,src_com_google_javascript_jscomp_DeadAssignmentsElimination,192,14,255,63,0,3,17,3,0,0,247,55,2,11,17,3,0,0
Closure/77,src_com_google_javascript_jscomp_CodeGenerator,814,35,885,71,0,0,37,2,0,0,870,56,8,15,37,2,0,0
Closure/78,src_com_google_javascript_jscomp_PeepholeFoldConstants,1195,41,1266,71,0,0,43,2,0,0,1262,67,0,4,43,2,0,0
Closure/79,src_com_google_javascript_jscomp_Normalize,503,48,525,22,0,0,50,2,0,0,522,19,0,3,50,2,0,0
Closure/79,src_com_google_javascript_jscomp_VarCheck,140,21,155,15,0,0,23,2,0,0,154,14,0,1,23,2,0,0
Closure/8,src_com_google_javascript_jscomp_CollapseVariableDeclarations,110,14,134,24,0,0,17,3,0,0,132,22,0,2,17,3,0,0
Closure/80,src_com_google_javascript_jscomp_NodeUtil,2244,184,2316,72,0,0,187,3,0,0,2312,68,0,4,187,3,0,0
Closure/81,src_com_google_javascript_jscomp_parsing_IRFactory,1063,82,1106,43,0,0,85,3,0,0,1103,40,0,3,85,3,0,0
Closure/82,src_com_google_javascript_rhino_jstype_JSType,651,102,662,11,0,0,104,2,0,0,662,11,0,0,104,2,0,0
Closure/83,src_com_google_javascript_jscomp_CommandLineRunner,160,57,197,37,0,0,61,4,0,0,191,31,0,6,61,4,0,0
Closure/84,src_com_google_javascript_jscomp_parsing_IRFactory,1027,77,1057,30,0,0,81,4,0,0,1051,24,0,6,81,4,0,0
Closure/85,src_com_google_javascript_jscomp_UnreachableCodeElimination,85,11,129,44,0,0,14,3,0,0,121,36,1,8,14,3,0,0
Closure/86,src_com_google_javascript_jscomp_NodeUtil,1874,153,1921,47,4,4,155,2,0,0,1918,44,2,7,155,2,0,0
Closure/87,src_com_google_javascript_jscomp_PeepholeSubstituteAlternateSyntax,672,33,688,16,0,0,35,2,0,0,686,14,0,2,35,2,0,0
Closure/88,src_com_google_javascript_jscomp_DeadAssignmentsElimination,197,14,224,27,0,0,16,2,0,0,221,24,0,3,16,2,0,0
Closure/89,src_com_google_javascript_jscomp_CollapseProperties,434,30,467,33,0,0,32,2,0,0,464,30,0,3,32,2,0,0
Closure/89,src_com_google_javascript_jscomp_GlobalNamespace,699,85,725,26,0,0,88,3,0,0,724,25,0,1,88,3,0,0
Closure/9,src_com_google_javascript_jscomp_ProcessCommonJSModules,155,27,193,38,0,0,31,4,0,0,189,34,0,4,31,4,0,0
Closure/90,src_com_google_javascript_jscomp_FunctionTypeBuilder,414,52,432,18,0,0,55,3,0,0,429,15,0,3,55,3,0,0
Closure/90,src_com_google_javascript_rhino_jstype_FunctionType,630,64,663,33,0,0,66,2,0,0,659,29,0,4,66,2,0,0
Closure/91,src_com_google_javascript_jscomp_CheckGlobalThis,49,8,90,41,0,0,10,2,0,0,86,37,0,4,10,2,0,0
Closure/92,src_com_google_javascript_jscomp_ProcessClosurePrimitives,548,60,604,56,0,0,63,3,0,0,604,56,0,0,63,3,0,0
Closure/94,src_com_google_javascript_jscomp_NodeUtil,1724,141,1753,29,0,0,143,2,0,0,1750,26,0,3,143,2,0,0
Closure/95,src_com_google_javascript_jscomp_TypedScopeCreator,947,81,1000,53,0,0,84,3,0,0,995,48,0,5,84,3,0,0
Closure/96,src_com_google_javascript_jscomp_TypeCheck,1008,82,1040,32,0,0,84,2,0,0,1036,28,0,4,84,2,0,0
Closure/97,src_com_google_javascript_jscomp_PeepholeFoldConstants,829,26,881,52,0,0,28,2,0,0,876,47,1,5,28,2,0,0
Closure/98,src_com_google_javascript_jscomp_ReferenceCollectingCallback,352,59,377,25,0,0,64,5,0,0,372,20,0,5,64,5,0,0
Closure/99,src_com_google_javascript_jscomp_CheckGlobalThis,49,8,93,44,0,0,10,2,0,0,81,32,1,12,10,2,0,0
Codec/1,src_java_org_apache_commons_codec_language_Caverphone,27,4,99,72,0,0,6,2,0,0,97,70,0,2,6,2,0,0
Codec/1,src_java_org_apache_commons_codec_language_Metaphone,89,15,303,214,0,0,17,2,0,0,301,212,0,2,17,2,0,0
Codec/1,src_java_org_apache_commons_codec_language_SoundexUtils,26,2,49,23,0,0,4,2,0,0,46,20,0,3,4,2,0,0
Codec/10,src_java_org_apache_commons_codec_language_Caverphone,27,4,100,73,0,0,6,2,0,0,98,71,0,2,6,2,0,0
Codec/12,src_main_java_org_apache_commons_codec_binary_BaseNCodecInputStream,66,7,70,4,0,0,8,1,0,0,70,4,0,0,8,1,0,0
Codec/13,src_main_java_org_apache_commons_codec_binary_StringUtils,141,17,145,4,0,0,18,1,0,0,145,4,0,0,18,1,0,0
Codec/13,src_main_java_org_apache_commons_codec_language_DoubleMetaphone,862,59,875,13,0,2,61,2,0,0,872,10,1,5,61,2,0,0
Codec/14,src_main_java_org_apache_commons_codec_language_bm_Lang,108,14,117,9,0,0,16,2,0,0,112,4,0,5,16,2,0,0
Codec/14,src_main_java_org_apache_commons_codec_language_bm_PhoneticEngine,265,38,303,38,0,1,40,2,0,0,295,30,0,9,40,2,0,0
Codec/14,src_main_java_org_apache_commons_codec_language_bm_Rule,525,63,560,35,0,0,66,3,0,0,536,11,0,24,66,3,0,0
Codec/16,src_main_java_org_apache_commons_codec_binary_Base32,247,24,251,4,0,0,26,2,0,0,251,4,0,0,26,2,0,0
Codec/17,src_main_java_org_apache_commons_codec_binary_StringUtils,169,19,181,12,0,0,21,2,0,0,179,10,0,2,21,2,0,0
Codec/2,src_java_org_apache_commons_codec_binary_Base64,382,51,448,66,0,0,53,2,0,0,445,63,0,3,53,2,0,0
Codec/3,src_java_org_apache_commons_codec_language_DoubleMetaphone,891,65,949,58,0,0,67,2,0,0,945,54,0,4,67,2,0,0
Codec/4,src_java_org_apache_commons_codec_binary_Base64,499,60,508,9,0,0,62,2,0,0,507,8,0,1,62,2,0,0
Codec/5,src_java_org_apache_commons_codec_binary_Base64,456,61,508,52,0,0,63,2,0,0,505,49,0,3,63,2,0,0
Codec/6,src_java_org_apache_commons_codec_binary_Base64InputStream,41,8,80,39,0,0,10,2,0,0,73,32,2,7,10,2,0,0
Codec/7,src_java_org_apache_commons_codec_binary_Base64,499,61,512,13,0,0,63,2,0,0,510,11,0,2,63,2,0,0
Codec/8,src_java_org_apache_commons_codec_binary_Base64,480,61,485,5,0,0,62,1,0,0,485,5,0,0,62,1,0,0
Codec/8,src_java_org_apache_commons_codec_binary_Base64InputStream,41,8,80,39,0,0,10,2,0,0,76,35,0,4,10,2,0,0
Codec/9,src_java_org_apache_commons_codec_binary_Base64,476,62,500,24,0,0,64,2,0,0,493,17,0,7,64,2,0,0
Collections/25,src_main_java_org_apache_commons_collections4_IteratorUtils,735,72,769,34,0,0,76,4,0,0,753,18,3,16,76,4,0,0
Collections/26,src_main_java_org_apache_commons_collections4_keyvalue_MultiKey,108,16,117,9,0,0,18,2,0,0,116,8,0,1,18,2,0,0
Collections/27,src_main_java_org_apache_commons_collections4_map_MultiValueMap,349,46,357,8,0,0,48,2,0,0,355,6,0,2,48,2,0,0
Collections/28,src_main_java_org_apache_commons_collections4_trie_AbstractPatriciaTrie,1851,214,1858,7,0,0,216,2,0,0,1858,7,0,0,216,2,0,0
Compress/1,src_main_java_org_apache_commons_compress_archivers_cpio_CpioArchiveOutputStream,280,26,294,14,0,0,28,2,0,0,293,13,0,1,28,2,0,0
Compress/10,src_main_java_org_apache_commons_compress_archivers_zip_ZipFile,459,65,501,42,0,0,67,2,0,0,497,38,2,4,67,2,0,0
Compress/11,src_main_java_org_apache_commons_compress_archivers_ArchiveStreamFactory,61,8,117,56,0,0,10,2,0,0,114,53,0,3,10,2,0,0
Compress/12,src_main_java_org_apache_commons_compress_archivers_tar_TarArchiveInputStream,303,30,358,55,0,0,32,2,0,0,356,53,0,2,32,2,0,0
Compress/13,src_main_java_org_apache_commons_compress_archivers_zip_ZipArchiveEntry,386,56,398,12,0,0,58,2,0,0,397,11,0,1,58,2,0,0
Compress/14,src_main_java_org_apache_commons_compress_archivers_tar_TarUtils,180,13,226,46,0,0,15,2,0,0,222,42,0,4,15,2,0,0
Compress/15,src_main_java_org_apache_commons_compress_archivers_zip_ZipArchiveEntry,361,56,399,38,0,0,58,2,0,0,394,33,0,5,58,2,0,0
Compress/16,src_main_java_org_apache_commons_compress_archivers_ArchiveStreamFactory,61,8,118,57,0,2,10,2,0,0,115,54,0,5,10,2,0,0
Compress/17,src_main_java_org_apache_commons_compress_archivers_tar_TarUtils,359,25,405,46,0,0,27,2,0,0,401,42,0,4,27,2,0,0
Compress/18,src_main_java_org_apache_commons_compress_archivers_tar_TarArchiveOutputStream,321,48,355,34,0,0,50,2,0,0,352,31,0,3,50,2,0,0
Compress/19,src_main_java_org_apache_commons_compress_archivers_zip_Zip64ExtendedInformationExtraField,174,25,211,37,0,0,27,2,0,0,206,32,0,5,27,2,0,0
Compress/2,src_main_java_org_apache_commons_compress_archivers_ar_ArArchiveInputStream,54,7,132,78,1,2,12,5,0,0,123,69,2,11,12,5,0,0
Compress/20,src_main_java_org_apache_commons_compress_archivers_cpio_CpioArchiveInputStream,277,28,375,98,0,0,32,4,0,0,367,90,0,8,32,4,0,0
Compress/21,src_main_java_org_apache_commons_compress_archivers_sevenz_SevenZOutputFile,605,46,630,25,3,4,48,2,0,0,623,18,0,11,48,2,0,0
Compress/22,src_main_java_org_apache_commons_compress_compressors_bzip2_BZip2CompressorInputStream,659,71,776,117,0,0,78,7,0,0,767,108,0,9,78,7,0,0
Compress/23,src_main_java_org_apache_commons_compress_archivers_sevenz_Coders,252,32,274,22,0,4,35,3,0,0,266,14,0,12,35,3,0,0
Compress/24,src_main_java_org_apache_commons_compress_archivers_tar_TarUtils,359,25,402,43,0,0,27,2,0,0,399,40,0,3,27,2,0,0
Compress/25,src_main_java_org_apache_commons_compress_archivers_zip_ZipArchiveInputStream,677,72,692,15,0,0,74,2,0,0,688,11,0,4,74,2,0,0
Compress/26,src_main_java_org_apache_commons_compress_utils_IOUtils,82,9,103,21,0,0,11,2,0,0,99,17,0,4,11,2,0,0
Compress/27,src_main_java_org_apache_commons_compress_archivers_tar_TarUtils,359,25,399,40,0,0,27,2,0,0,396,37,0,3,27,2,0,0
Compress/28,src_main_java_org_apache_commons_compress_archivers_tar_TarArchiveInputStream,392,40,421,29,0,0,42,2,0,0,416,24,0,5,42,2,0,0
Compress/29,src_main_java_org_apache_commons_compress_archivers_ArchiveStreamFactory,88,15,212,124,0,0,18,3,0,0,204,116,1,8,18,3,0,0
Compress/29,src_main_java_org_apache_commons_compress_archivers_cpio_CpioArchiveInputStream,361,33,375,14,0,0,35,2,0,0,372,11,0,3,35,2,0,0
Compress/29,src_main_java_org_apache_commons_compress_archivers_cpio_CpioArchiveOutputStream,346,30,370,24,0,0,32,2,0,0,366,20,0,4,32,2,0,0
Compress/29,src_main_java_org_apache_commons_compress_archivers_dump_DumpArchiveInputStream,292,30,321,29,0,0,32,2,0,0,318,26,0,3,32,2,0,0
Compress/29,src_main_java_org_apache_commons_compress_archivers_tar_TarArchiveInputStream,423,42,439,16,0,0,44,2,0,0,435,12,0,4,44,2,0,0
Compress/29,src_main_java_org_apache_commons_compress_archivers_tar_TarArchiveOutputStream,427,58,445,18,0,0,60,2,0,0,441,14,0,4,60,2,0,0
Compress/29,src_main_java_org_apache_commons_compress_archivers_zip_ZipArchiveInputStream,677,72,693,16,0,0,74,2,0,0,689,12,0,4,74,2,0,0
Compress/3,src_main_java_org_apache_commons_compress_archivers_tar_TarArchiveOutputStream,107,23,164,57,0,0,27,4,0,0,160,53,0,4,27,4,0,0
Compress/30,src_main_java_org_apache_commons_compress_compressors_bzip2_BZip2CompressorInputStream,740,76,775,35,0,0,78,2,0,0,770,30,0,5,78,2,0,0
Compress/31,src_main_java_org_apache_commons_compress_archivers_tar_TarUtils,358,25,398,40,0,0,27,2,0,0,395,37,0,3,27,2,0,0
Compress/32,src_main_java_org_apache_commons_compress_archivers_tar_TarArchiveInputStream,397,43,444,47,0,0,45,2,0,0,443,46,0,1,45,2,0,0
Compress/33,src_main_java_org_apache_commons_compress_compressors_CompressorStreamFactory,96,17,141,45,0,0,19,2,0,0,138,42,0,3,19,2,0,0
Compress/33,src_main_java_org_apache_commons_compress_compressors_deflate_DeflateCompressorInputStream,54,8,58,4,0,0,9,1,0,0,58,4,0,0,9,1,0,0
Compress/34,src_main_java_org_apache_commons_compress_archivers_zip_X7875_NewUnix,149,23,159,10,0,1,25,2,0,0,158,9,0,2,25,2,0,0
Compress/35,src_main_java_org_apache_commons_compress_archivers_tar_TarUtils,370,25,391,21,0,1,27,2,0,0,390,20,0,2,27,2,0,0
Compress/36,src_main_java_org_apache_commons_compress_archivers_sevenz_SevenZFile,846,38,864,18,0,0,40,2,0,0,862,16,0,2,40,2,0,0
Compress/37,src_main_java_org_apache_commons_compress_archivers_tar_TarArchiveInputStream,424,46,472,48,0,0,48,2,0,0,467,43,2,5,48,2,0,0
Compress/38,src_main_java_org_apache_commons_compress_archivers_tar_TarArchiveEntry,638,100,659,21,0,0,102,2,0,0,658,20,0,1,102,2,0,0
Compress/39,src_main_java_org_apache_commons_compress_utils_ArchiveUtils,170,13,195,25,0,0,15,2,0,0,193,23,0,2,15,2,0,0
Compress/4,src_main_java_org_apache_commons_compress_archivers_cpio_CpioArchiveOutputStream,260,24,274,14,0,0,26,2,0,0,273,13,0,1,26,2,0,0
Compress/4,src_main_java_org_apache_commons_compress_archivers_tar_TarArchiveOutputStream,154,26,168,14,0,0,28,2,0,0,167,13,0,1,28,2,0,0
Compress/4,src_main_java_org_apache_commons_compress_archivers_zip_ZipArchiveOutputStream,437,71,452,15,0,0,73,2,0,0,451,14,0,1,73,2,0,0
Compress/4,src_main_java_org_apache_commons_compress_changes_ChangeSetPerformer,37,4,96,59,0,0,6,2,0,0,92,55,0,4,6,2,0,0
Compress/40,src_main_java_org_apache_commons_compress_utils_BitInputStream,20,9,59,39,1,1,11,2,0,0,52,32,2,8,11,2,0,0
Compress/41,src_main_java_org_apache_commons_compress_archivers_zip_ZipArchiveInputStream,620,74,708,88,0,0,76,2,0,0,705,85,0,3,76,2,0,0
Compress/42,src_main_java_org_apache_commons_compress_archivers_zip_UnixStat,0,7,3,3,0,0,8,1,0,0,3,3,0,0,8,1,0,0
Compress/42,src_main_java_org_apache_commons_compress_archivers_zip_ZipArchiveEntry,499,77,510,11,0,0,79,2,0,0,510,11,0,0,79,2,0,0
Compress/43,src_main_java_org_apache_commons_compress_archivers_zip_ZipArchiveOutputStream,788,144,899,111,0,0,149,5,0,0,884,96,0,15,149,5,0,0
Compress/44,src_main_java_org_apache_commons_compress_utils_ChecksumCalculatingInputStream,49,7,60,11,0,0,9,2,0,0,58,9,0,2,9,2,0,0
Compress/45,src_main_java_org_apache_commons_compress_archivers_tar_TarUtils,374,25,397,23,0,0,27,2,0,0,393,19,0,4,27,2,0,0
Compress/46,src_main_java_org_apache_commons_compress_archivers_zip_X5455_ExtendedTimestamp,270,44,286,16,2,2,46,2,0,0,283,13,0,5,46,2,0,0
Compress/47,src_main_java_org_apache_commons_compress_archivers_zip_ZipArchiveInputStream,676,73,729,53,0,0,76,3,0,0,722,46,0,7,76,3,0,0
Compress/5,src_main_java_org_apache_commons_compress_archivers_zip_ZipArchiveInputStream,190,27,253,63,0,0,29,2,0,0,247,57,1,6,29,2,0,0
Compress/6,src_main_java_org_apache_commons_compress_archivers_zip_ZipArchiveEntry,265,43,299,34,0,0,46,3,0,0,296,31,0,3,46,3,0,0
Compress/7,src_main_java_org_apache_commons_compress_archivers_tar_TarUtils,129,9,150,21,0,1,11,2,0,0,145,16,0,6,11,2,0,0
Compress/9,src_main_java_org_apache_commons_compress_archivers_tar_TarArchiveOutputStream,150,27,195,45,0,0,29,2,0,0,190,40,0,5,29,2,0,0
Csv/1,src_main_java_org_apache_commons_csv_ExtendedBufferedReader,67,10,83,16,0,0,12,2,0,0,79,12,0,4,12,2,0,0
Csv/10,src_main_java_org_apache_commons_csv_CSVPrinter,278,17,295,17,0,0,19,2,0,0,291,13,0,4,19,2,0,0
Csv/11,src_main_java_org_apache_commons_csv_CSVParser,192,25,231,39,0,0,27,2,0,0,228,36,0,3,27,2,0,0
Csv/12,src_main_java_org_apache_commons_csv_CSVFormat,432,60,438,6,0,0,62,2,0,0,437,5,0,1,62,2,0,0
Csv/13,src_main_java_org_apache_commons_csv_CSVFormat,542,79,548,6,0,0,81,2,0,0,547,5,0,1,81,2,0,0
Csv/13,src_main_java_org_apache_commons_csv_CSVPrinter,279,17,306,27,0,0,19,2,0,0,300,21,0,6,19,2,0,0
Csv/14,src_main_java_org_apache_commons_csv_CSVFormat,730,100,818,88,0,0,102,2,0,0,810,80,0,8,102,2,0,0
Csv/15,src_main_java_org_apache_commons_csv_CSVFormat,757,106,843,86,0,0,108,2,0,0,833,76,2,10,108,2,0,0
Csv/16,src_main_java_org_apache_commons_csv_CSVParser,256,29,281,25,0,2,32,3,0,0,272,16,0,11,32,3,0,0
Csv/2,src_main_java_org_apache_commons_csv_CSVRecord,63,17,77,14,0,0,19,2,0,0,75,12,0,2,19,2,0,0
Csv/3,src_main_java_org_apache_commons_csv_Lexer,83,22,112,29,0,0,24,2,0,0,111,28,0,1,24,2,0,0
Csv/4,src_main_java_org_apache_commons_csv_CSVParser,206,24,216,10,0,0,26,2,0,0,214,8,0,2,26,2,0,0
Csv/5,src_main_java_org_apache_commons_csv_CSVPrinter,276,17,290,14,0,0,19,2,0,0,288,12,0,2,19,2,0,0
Csv/6,src_main_java_org_apache_commons_csv_CSVRecord,96,21,111,15,0,0,23,2,0,0,107,11,0,4,23,2,0,0
Csv/7,src_main_java_org_apache_commons_csv_CSVParser,192,25,224,32,0,0,27,2,0,0,221,29,0,3,27,2,0,0
Csv/8,src_main_java_org_apache_commons_csv_CSVFormat,350,55,409,59,1,7,58,3,0,0,396,46,0,20,58,3,0,0
Csv/9,src_main_java_org_apache_commons_csv_CSVRecord,96,21,113,17,0,0,23,2,0,0,109,13,0,4,23,2,0,0
Gson/1,gson_src_main_java_com_google_gson_TypeInfoFactory,49,5,96,47,0,0,7,2,0,0,91,42,0,5,7,2,0,0
Gson/10,gson_src_main_java_com_google_gson_internal_bind_ReflectiveTypeAdapterFactory,222,25,261,39,0,0,28,3,0,0,244,22,0,17,27,2,0,1
Gson/11,gson_src_main_java_com_google_gson_internal_bind_TypeAdapters,1043,139,1063,20,0,0,142,3,0,0,1046,3,0,17,141,2,0,1
Gson/12,gson_src_main_java_com_google_gson_internal_bind_JsonTreeReader,317,31,336,19,0,0,33,2,0,0,333,16,0,3,33,2,0,0
Gson/13,gson_src_main_java_com_google_gson_stream_JsonReader,1077,81,1180,103,0,0,83,2,0,0,1175,98,0,5,83,2,0,0
Gson/14,gson_src_main_java_com_google_gson_internal_$Gson$Types,498,50,520,22,0,0,53,3,0,0,515,17,0,5,53,3,0,0
Gson/15,gson_src_main_java_com_google_gson_stream_JsonWriter,372,43,411,39,0,0,45,2,0,0,386,14,0,25,45,2,0,0
Gson/16,gson_src_main_java_com_google_gson_internal_$Gson$Types,466,52,538,72,0,0,54,2,0,0,532,66,0,6,54,2,0,0
Gson/17,gson_src_main_java_com_google_gson_DefaultDateTypeAdapter,83,13,105,22,1,4,15,2,0,0,100,17,0,9,15,2,0,0
Gson/18,gson_src_main_java_com_google_gson_internal_$Gson$Types,530,52,543,13,0,0,54,2,0,0,538,8,0,5,54,2,0,0
Gson/2,gson_src_main_java_com_google_gson_internal_bind_TypeAdapters,917,121,942,25,0,1,124,3,0,0,929,12,0,14,123,2,0,1
Gson/3,gson_src_main_java_com_google_gson_internal_ConstructorConstructor,157,19,196,39,0,0,21,2,0,0,190,33,0,6,21,2,0,0
Gson/4,gson_src_main_java_com_google_gson_stream_JsonReader,1020,82,1156,136,0,0,84,2,0,0,1151,131,0,5,84,2,0,0
Gson/4,gson_src_main_java_com_google_gson_stream_JsonWriter,241,34,397,156,0,0,44,10,0,0,351,110,0,46,44,10,0,0
Gson/5,gson_src_main_java_com_google_gson_internal_bind_util_ISO8601Utils,122,9,243,121,0,0,11,2,0,0,239,117,0,4,11,2,0,0
Gson/6,gson_src_main_java_com_google_gson_internal_bind_JsonAdapterAnnotationTypeAdapterFactory,19,3,47,28,0,0,5,2,0,0,40,21,0,7,5,2,0,0
Gson/7,gson_src_main_java_com_google_gson_stream_JsonReader,1063,81,1158,95,0,0,84,3,0,0,1152,89,0,6,84,3,0,0
Gson/8,gson_src_main_java_com_google_gson_internal_UnsafeAllocator,15,2,79,64,0,0,7,5,0,0,48,33,0,31,4,2,0,3
Gson/9,gson_src_main_java_com_google_gson_internal_bind_JsonTreeWriter,212,25,217,5,0,0,26,1,0,0,216,4,0,1,26,1,0,0
Gson/9,gson_src_main_java_com_google_gson_internal_bind_TypeAdapters,1050,139,1063,13,0,0,142,3,0,0,1053,3,0,10,141,2,0,1
Gson/9,gson_src_main_java_com_google_gson_stream_JsonWriter,372,43,397,25,0,0,44,1,0,0,377,5,0,20,44,1,0,0
JacksonCore/1,src_main_java_com_fasterxml_jackson_core_io_NumberInput,269,15,291,22,0,0,18,3,0,0,282,13,0,9,18,3,0,0
JacksonCore/1,src_main_java_com_fasterxml_jackson_core_util_TextBuffer,433,44,454,21,0,0,46,2,0,0,447,14,0,7,46,2,0,0
JacksonCore/10,src_main_java_com_fasterxml_jackson_core_sym_ByteQuadsCanonicalizer,800,77,842,42,3,2,80,3,0,0,839,39,3,5,80,3,0,0
JacksonCore/11,src_main_java_com_fasterxml_jackson_core_sym_ByteQuadsCanonicalizer,831,78,847,16,0,0,80,2,0,0,846,15,0,1,80,2,0,0
JacksonCore/12,src_main_java_com_fasterxml_jackson_core_json_ReaderBasedJsonParser,1994,78,2380,386,0,0,85,7,0,0,2364,370,0,16,85,7,0,0
JacksonCore/12,src_main_java_com_fasterxml_jackson_core_json_UTF8StreamJsonParser,3156,112,3170,14,0,0,114,2,0,0,3168,12,0,2,114,2,0,0
JacksonCore/13,src_main_java_com_fasterxml_jackson_core_json_JsonGeneratorImpl,90,17,95,5,0,0,18,1,0,0,95,5,0,0,18,1,0,0
JacksonCore/14,src_main_java_com_fasterxml_jackson_core_io_IOContext,169,33,200,31,0,0,37,4,0,0,195,26,0,5,37,4,0,0
JacksonCore/15,src_main_java_com_fasterxml_jackson_core_filter_FilteringParserDelegate,655,62,825,170,0,0,64,2,0,0,822,167,0,3,64,2,0,0
JacksonCore/17,src_main_java_com_fasterxml_jackson_core_json_UTF8JsonGenerator,1732,95,1797,65,0,2,99,4,0,0,1778,46,0,21,99,4,0,0
JacksonCore/18,src_main_java_com_fasterxml_jackson_core_base_GeneratorBase,326,47,338,12,0,0,50,3,0,0,335,9,0,3,50,3,0,0
JacksonCore/18,src_main_java_com_fasterxml_jackson_core_json_UTF8JsonGenerator,1826,98,1846,20,0,0,100,2,0,0,1843,17,0,3,100,2,0,0
JacksonCore/18,src_main_java_com_fasterxml_jackson_core_json_WriterBasedJsonGenerator,1662,74,1683,21,0,0,76,2,0,0,1679,17,0,4,76,2,0,0
JacksonCore/19,src_main_java_com_fasterxml_jackson_core_json_ReaderBasedJsonParser,2283,83,2391,108,0,0,85,2,0,0,2383,100,4,8,85,2,0,0
JacksonCore/19,src_main_java_com_fasterxml_jackson_core_json_UTF8StreamJsonParser,3082,112,3170,88,0,0,114,2,0,0,3159,77,4,11,114,2,0,0
JacksonCore/2,src_main_java_com_fasterxml_jackson_core_json_ReaderBasedJsonParser,1408,57,1628,220,0,0,61,4,0,0,1618,210,0,10,61,4,0,0
JacksonCore/2,src_main_java_com_fasterxml_jackson_core_json_UTF8StreamJsonParser,2402,87,2667,265,0,0,93,6,0,0,2642,240,0,25,93,6,0,0
JacksonCore/20,src_main_java_com_fasterxml_jackson_core_JsonGenerator,906,112,921,15,0,0,114,2,0,0,917,11,0,4,114,2,0,0
JacksonCore/21,src_main_java_com_fasterxml_jackson_core_filter_FilteringParserDelegate,670,64,853,183,0,0,66,2,0,0,846,176,4,7,66,2,0,0
JacksonCore/22,src_main_java_com_fasterxml_jackson_core_filter_FilteringParserDelegate,419,62,849,430,0,0,66,4,0,0,834,415,7,15,66,4,0,0
JacksonCore/23,src_main_java_com_fasterxml_jackson_core_util_DefaultPrettyPrinter,278,45,289,11,0,0,47,2,0,0,286,8,0,3,47,2,0,0
JacksonCore/25,src_main_java_com_fasterxml_jackson_core_json_ReaderBasedJsonParser,2463,91,2511,48,0,0,93,2,0,0,2506,43,0,5,93,2,0,0
JacksonCore/26,src_main_java_com_fasterxml_jackson_core_json_async_NonBlockingJsonParser,2502,76,2531,29,0,0,78,2,0,0,2526,24,0,5,78,2,0,0
JacksonCore/3,src_main_java_com_fasterxml_jackson_core_json_UTF8StreamJsonParser,2700,93,2724,24,0,0,95,2,0,0,2715,15,0,9,95,2,0,0
JacksonCore/4,src_main_java_com_fasterxml_jackson_core_util_TextBuffer,454,45,466,12,0,4,47,2,0,0,463,9,0,7,47,2,0,0
JacksonCore/5,src_main_java_com_fasterxml_jackson_core_JsonPointer,171,23,199,28,0,0,25,2,0,0,198,27,0,1,25,2,0,0
JacksonCore/6,src_main_java_com_fasterxml_jackson_core_JsonPointer,171,23,201,30,0,0,25,2,0,0,199,28,0,2,25,2,0,0
JacksonCore/7,src_main_java_com_fasterxml_jackson_core_json_JsonWriteContext,155,28,175,20,0,0,30,2,0,0,173,18,2,2,30,2,0,0
JacksonCore/8,src_main_java_com_fasterxml_jackson_core_util_TextBuffer,464,46,483,19,0,0,48,2,0,0,481,17,0,2,48,2,0,0
JacksonCore/9,src_main_java_com_fasterxml_jackson_core_base_ParserMinimalBase,547,70,576,29,0,0,73,3,0,0,569,22,0,7,73,3,0,0
JacksonCore/9,src_main_java_com_fasterxml_jackson_core_json_ReaderBasedJsonParser,1945,69,1980,35,0,0,72,3,0,0,1973,28,0,7,72,3,0,0
JacksonCore/9,src_main_java_com_fasterxml_jackson_core_json_UTF8StreamJsonParser,3100,106,3133,33,0,0,109,3,0,0,3126,26,0,7,109,3,0,0
JacksonDatabind/1,src_main_java_com_fasterxml_jackson_databind_ser_BeanPropertyWriter,405,56,454,49,0,0,58,2,0,0,450,45,0,4,58,2,0,0
JacksonDatabind/10,src_main_java_com_fasterxml_jackson_databind_ser_AnyGetterWriter,0,3,61,61,0,1,8,5,0,0,44,44,0,18,8,5,0,0
JacksonDatabind/10,src_main_java_com_fasterxml_jackson_databind_ser_BeanSerializerFactory,390,21,456,66,0,2,23,2,0,0,451,61,0,7,23,2,0,0
JacksonDatabind/100,src_main_java_com_fasterxml_jackson_databind_node_TreeTraversingParser,334,38,352,18,0,0,40,2,0,0,346,12,0,6,40,2,0,0
JacksonDatabind/101,src_main_java_com_fasterxml_jackson_databind_deser_BeanDeserializer,757,39,837,80,0,0,41,2,0,0,832,75,0,5,41,2,0,0
JacksonDatabind/102,src_main_java_com_fasterxml_jackson_databind_ser_std_DateTimeSerializerBase,101,13,161,60,0,0,15,2,0,0,155,54,0,6,15,2,0,0
JacksonDatabind/103,src_main_java_com_fasterxml_jackson_databind_DatabindContext,204,25,236,32,0,0,27,2,0,0,232,28,0,4,27,2,0,0
JacksonDatabind/103,src_main_java_com_fasterxml_jackson_databind_DeserializationContext,1039,106,1079,40,0,0,109,3,0,0,1073,34,0,6,109,3,0,0
JacksonDatabind/103,src_main_java_com_fasterxml_jackson_databind_JsonMappingException,350,52,392,42,0,0,55,3,0,0,383,33,0,9,55,3,0,0
JacksonDatabind/103,src_main_java_com_fasterxml_jackson_databind_SerializerProvider,795,84,839,44,0,0,87,3,0,0,833,38,0,6,87,3,0,0
JacksonDatabind/103,src_main_java_com_fasterxml_jackson_databind_deser_BasicDeserializerFactory,1539,69,1596,57,0,0,71,2,0,0,1576,37,0,20,71,2,0,0
JacksonDatabind/103,src_main_java_com_fasterxml_jackson_databind_deser_BeanDeserializerFactory,514,24,609,95,0,0,27,3,0,0,597,83,0,12,27,3,0,0
JacksonDatabind/103,src_main_java_com_fasterxml_jackson_databind_deser_DeserializerCache,328,22,362,34,0,0,24,2,0,0,356,28,0,6,24,2,0,0
JacksonDatabind/103,src_main_java_com_fasterxml_jackson_databind_deser_SettableAnyProperty,157,27,190,33,0,0,29,2,0,0,183,26,0,7,29,2,0,0
JacksonDatabind/103,src_main_java_com_fasterxml_jackson_databind_deser_SettableBeanProperty,593,88,635,42,0,0,91,3,0,0,623,30,0,12,91,3,0,0
JacksonDatabind/103,src_main_java_com_fasterxml_jackson_databind_deser_std_StdDeserializer,954,66,975,21,0,0,68,2,0,0,971,17,0,4,68,2,0,0
JacksonDatabind/103,src_main_java_com_fasterxml_jackson_databind_deser_std_StdKeyDeserializer,369,62,411,42,0,0,65,3,0,0,400,31,0,11,65,3,0,0
JacksonDatabind/103,src_main_java_com_fasterxml_jackson_databind_deser_std_StdValueInstantiator,436,62,456,20,0,0,64,2,0,0,452,16,0,4,64,2,0,0
JacksonDatabind/103,src_main_java_com_fasterxml_jackson_databind_introspect_BasicBeanDescription,526,53,556,30,0,0,55,2,0,0,553,27,0,3,55,2,0,0
JacksonDatabind/103,src_main_java_com_fasterxml_jackson_databind_ser_DefaultSerializerProvider,404,33,445,41,0,0,36,3,0,0,436,32,0,9,36,3,0,0
JacksonDatabind/103,src_main_java_com_fasterxml_jackson_databind_ser_PropertyBuilder,97,14,215,118,0,0,16,2,0,0,205,108,0,10,16,2,0,0
JacksonDatabind/103,src_main_java_com_fasterxml_jackson_databind_util_ClassUtil,1024,94,1028,4,0,0,95,1,0,0,1027,3,0,1,95,1,0,0
JacksonDatabind/104,src_main_java_com_fasterxml_jackson_databind_util_StdDateFormat,470,57,546,76,0,0,60,3,0,0,524,54,0,22,60,3,0,0
JacksonDatabind/105,src_main_java_com_fasterxml_jackson_databind_deser_std_JdkDeserializers,0,1,37,37,0,0,3,2,0,0,26,26,0,11,3,2,0,0
JacksonDatabind/106,src_main_java_com_fasterxml_jackson_databind_node_TreeTraversingParser,328,37,348,20,0,0,40,3,0,0,344,16,0,4,40,3,0,0
JacksonDatabind/107,src_main_java_com_fasterxml_jackson_databind_jsontype_impl_TypeDeserializerBase,155,24,192,37,0,0,26,2,0,0,188,33,0,4,26,2,0,0
JacksonDatabind/108,src_main_java_com_fasterxml_jackson_databind_ObjectReader,1307,139,1324,17,0,0,141,2,0,0,1318,11,0,6,141,2,0,0
JacksonDatabind/109,src_main_java_com_fasterxml_jackson_databind_ser_std_NumberSerializer,60,5,81,21,0,0,8,3,0,0,74,14,0,7,8,3,0,0
JacksonDatabind/109,src_main_java_com_fasterxml_jackson_databind_ser_std_NumberSerializers,191,31,216,25,0,0,34,3,0,0,209,18,0,7,34,3,0,0
JacksonDatabind/11,src_main_java_com_fasterxml_jackson_databind_type_TypeFactory,711,67,734,23,0,0,69,2,0,0,728,17,0,6,69,2,0,0
JacksonDatabind/110,src_main_java_com_fasterxml_jackson_databind_deser_impl_JavaUtilCollectionsDeserializers,94,24,136,42,0,0,26,2,0,0,122,28,0,14,26,2,0,0
JacksonDatabind/111,src_main_java_com_fasterxml_jackson_databind_deser_CreatorProperty,199,28,214,15,0,0,30,2,0,0,210,11,1,4,30,2,0,0
JacksonDatabind/111,src_main_java_com_fasterxml_jackson_databind_deser_impl_FieldProperty,174,18,190,16,0,0,20,2,0,0,185,11,1,5,20,2,0,0
JacksonDatabind/111,src_main_java_com_fasterxml_jackson_databind_deser_impl_MethodProperty,174,18,190,16,0,0,20,2,0,0,185,11,1,5,20,2,0,0
JacksonDatabind/111,src_main_java_com_fasterxml_jackson_databind_deser_impl_ObjectIdReferenceProperty,143,20,158,15,0,0,22,2,0,0,154,11,1,4,22,2,0,0
JacksonDatabind/111,src_main_java_com_fasterxml_jackson_databind_deser_impl_ObjectIdValueProperty,102,13,118,16,0,0,15,2,0,0,113,11,1,5,15,2,0,0
JacksonDatabind/111,src_main_java_com_fasterxml_jackson_databind_deser_impl_SetterlessProperty,122,15,138,16,0,0,17,2,0,0,133,11,1,5,17,2,0,0
JacksonDatabind/111,src_main_java_com_fasterxml_jackson_databind_deser_std_AtomicReferenceDeserializer,53,8,64,11,0,0,10,2,0,0,60,7,0,4,10,2,0,0
JacksonDatabind/112,src_main_java_com_fasterxml_jackson_databind_deser_std_StringCollectionDeserializer,174,15,212,38,0,0,17,2,0,0,205,31,0,7,17,2,0,0
JacksonDatabind/12,src_main_java_com_fasterxml_jackson_databind_deser_std_MapDeserializer,518,46,528,10,0,0,48,2,0,0,526,8,0,2,48,2,0,0
JacksonDatabind/13,src_main_java_com_fasterxml_jackson_databind_deser_DefaultDeserializationContext,206,23,248,42,0,0,25,2,0,0,243,37,0,5,25,2,0,0
JacksonDatabind/13,src_main_java_com_fasterxml_jackson_databind_deser_impl_ObjectIdValueProperty,89,13,111,22,0,0,15,2,0,0,104,15,0,7,15,2,0,0
JacksonDatabind/14,src_main_java_com_fasterxml_jackson_databind_ObjectReader,1171,122,1199,28,0,0,124,2,0,0,1194,23,0,5,124,2,0,0
JacksonDatabind/15,src_main_java_com_fasterxml_jackson_databind_JavaType,310,51,317,7,0,0,52,1,0,0,317,7,0,0,52,1,0,0
JacksonDatabind/15,src_main_java_com_fasterxml_jackson_databind_ser_BeanSerializerFactory,415,21,459,44,0,0,23,2,0,0,453,38,0,6,23,2,0,0
JacksonDatabind/15,src_main_java_com_fasterxml_jackson_databind_ser_std_BeanSerializerBase,576,34,603,27,0,0,36,2,0,0,598,22,0,5,36,2,0,0
JacksonDatabind/15,src_main_java_com_fasterxml_jackson_databind_ser_std_StdDelegatingSerializer,94,13,176,82,0,1,20,7,0,0,146,52,2,31,20,7,0,0
JacksonDatabind/15,src_main_java_com_fasterxml_jackson_databind_ser_std_StdSerializer,164,17,193,29,0,0,19,2,0,0,188,24,0,5,19,2,0,0
JacksonDatabind/16,src_main_java_com_fasterxml_jackson_databind_introspect_AnnotationMap,80,10,99,19,0,0,12,2,0,0,97,17,0,2,12,2,0,0
JacksonDatabind/17,src_main_java_com_fasterxml_jackson_databind_ObjectMapper,2024,231,2057,33,0,0,236,5,0,0,2055,31,0,2,236,5,0,0
JacksonDatabind/19,src_main_java_com_fasterxml_jackson_databind_type_TypeFactory,758,68,777,19,0,0,70,2,0,0,773,15,0,4,70,2,0,0
JacksonDatabind/2,src_main_java_com_fasterxml_jackson_databind_util_TokenBuffer,1562,161,1583,21,0,0,164,3,0,0,1576,14,0,7,164,3,0,0
JacksonDatabind/20,src_main_java_com_fasterxml_jackson_databind_node_ObjectNode,535,61,551,16,0,0,63,2,0,0,549,14,0,2,63,2,0,0
JacksonDatabind/21,src_main_java_com_fasterxml_jackson_databind_introspect_JacksonAnnotationIntrospector,861,77,881,20,0,0,79,2,0,0,878,17,0,3,79,2,0,0
JacksonDatabind/22,src_main_java_com_fasterxml_jackson_databind_ser_BasicSerializerFactory,556,39,792,236,1,1,44,5,0,0,695,139,26,98,44,5,0,0
JacksonDatabind/22,src_main_java_com_fasterxml_jackson_databind_ser_BeanSerializerFactory,432,22,492,60,0,0,24,2,0,0,480,48,4,12,24,2,0,0
JacksonDatabind/23,src_main_java_com_fasterxml_jackson_databind_ser_std_NumberSerializers,164,26,231,67,0,0,36,10,0,0,199,35,0,32,36,10,0,0
JacksonDatabind/24,src_main_java_com_fasterxml_jackson_databind_cfg_BaseSettings,196,37,211,15,0,0,39,2,0,0,207,11,1,4,39,2,0,0
JacksonDatabind/25,src_main_java_com_fasterxml_jackson_databind_deser_BasicDeserializerFactory,1372,63,1453,81,0,0,65,2,0,0,1431,59,0,22,65,2,0,0
JacksonDatabind/25,src_main_java_com_fasterxml_jackson_databind_deser_DeserializerCache,293,22,368,75,0,0,24,2,0,0,362,69,0,6,24,2,0,0
JacksonDatabind/25,src_main_java_com_fasterxml_jackson_databind_jsontype_impl_TypeDeserializerBase,150,22,183,33,0,0,24,2,0,0,179,29,0,4,24,2,0,0
JacksonDatabind/25,src_main_java_com_fasterxml_jackson_databind_module_SimpleAbstractTypeResolver,26,4,46,20,0,0,6,2,0,0,39,13,0,7,6,2,0,0
JacksonDatabind/26,src_main_java_com_fasterxml_jackson_databind_ser_BeanPropertyWriter,588,72,594,6,0,0,73,1,0,0,593,5,0,1,73,1,0,0
JacksonDatabind/27,src_main_java_com_fasterxml_jackson_databind_deser_BeanDeserializer,631,25,705,74,0,0,27,2,0,0,700,69,0,5,27,2,0,0
JacksonDatabind/29,src_main_java_com_fasterxml_jackson_databind_deser_impl_ExternalTypeHandler,228,26,274,46,0,0,29,3,0,0,260,32,0,14,29,3,0,0
JacksonDatabind/3,src_main_java_com_fasterxml_jackson_databind_deser_std_StringArrayDeserializer,62,8,126,64,1,2,11,3,0,0,114,52,0,14,11,3,0,0
JacksonDatabind/30,src_main_java_com_fasterxml_jackson_databind_ObjectMapper,2168,256,2231,63,0,0,259,3,0,0,2221,53,0,10,259,3,0,0
JacksonDatabind/30,src_main_java_com_fasterxml_jackson_databind_util_TokenBuffer,1505,161,1597,92,0,0,165,4,0,0,1589,84,1,8,165,4,0,0
JacksonDatabind/31,src_main_java_com_fasterxml_jackson_databind_util_TokenBuffer,1412,148,1627,215,0,0,167,19,0,0,1535,123,0,92,167,19,0,0
JacksonDatabind/32,src_main_java_com_fasterxml_jackson_databind_deser_std_UntypedObjectDeserializer,384,27,499,115,0,0,33,6,0,0,486,102,0,13,33,6,0,0
JacksonDatabind/33,src_main_java_com_fasterxml_jackson_databind_introspect_JacksonAnnotationIntrospector,911,78,938,27,0,0,80,2,0,0,935,24,0,3,80,2,0,0
JacksonDatabind/34,src_main_java_com_fasterxml_jackson_databind_ser_std_NumberSerializer,46,5,70,24,0,0,7,2,0,0,64,18,0,6,7,2,0,0
JacksonDatabind/35,src_main_java_com_fasterxml_jackson_databind_jsontype_impl_AsWrapperTypeDeserializer,64,9,105,41,3,3,11,2,0,0,100,36,2,8,11,2,0,0
JacksonDatabind/36,src_main_java_com_fasterxml_jackson_databind_util_StdDateFormat,345,41,391,46,0,0,44,3,0,0,372,27,0,19,44,3,0,0
JacksonDatabind/37,src_main_java_com_fasterxml_jackson_databind_type_SimpleType,198,21,212,14,0,0,23,2,0,0,209,11,0,3,23,2,0,0
JacksonDatabind/38,src_main_java_com_fasterxml_jackson_databind_type_CollectionType,100,13,114,14,0,0,15,2,0,0,108,8,1,6,15,2,0,0
JacksonDatabind/38,src_main_java_com_fasterxml_jackson_databind_type_MapType,127,16,142,15,0,0,18,2,0,0,135,8,1,7,18,2,0,0
JacksonDatabind/38,src_main_java_com_fasterxml_jackson_databind_type_SimpleType,184,20,215,31,0,0,23,3,0,0,209,25,0,6,23,3,0,0
JacksonDatabind/39,src_main_java_com_fasterxml_jackson_databind_deser_std_NullifyingDeserializer,20,4,33,13,0,0,6,2,0,0,28,8,0,5,6,2,0,0
JacksonDatabind/4,src_main_java_com_fasterxml_jackson_databind_deser_std_StringArrayDeserializer,62,8,128,66,0,0,11,3,0,0,117,55,0,11,11,3,0,0
JacksonDatabind/40,src_main_java_com_fasterxml_jackson_databind_deser_std_NumberDeserializers,526,74,539,13,0,0,76,2,0,0,533,7,0,6,76,2,0,0
JacksonDatabind/42,src_main_java_com_fasterxml_jackson_databind_deser_std_FromStringDeserializer,205,23,224,19,0,0,26,3,0,0,219,14,0,5,26,3,0,0
JacksonDatabind/43,src_main_java_com_fasterxml_jackson_databind_deser_impl_ObjectIdValueProperty,81,12,106,25,0,0,14,2,0,0,98,17,0,8,14,2,0,0
JacksonDatabind/44,src_main_java_com_fasterxml_jackson_databind_type_SimpleType,214,22,229,15,0,0,24,2,0,0,225,11,0,4,24,2,0,0
JacksonDatabind/45,src_main_java_com_fasterxml_jackson_databind_ser_std_DateTimeSerializerBase,90,12,124,34,3,1,14,2,0,0,117,27,0,8,14,2,0,0
JacksonDatabind/46,src_main_java_com_fasterxml_jackson_databind_type_ReferenceType,153,20,168,15,0,0,22,2,0,0,165,12,0,3,22,2,0,0
JacksonDatabind/47,src_main_java_com_fasterxml_jackson_databind_AnnotationIntrospector,584,88,662,78,0,0,90,2,0,0,656,72,0,6,90,2,0,0
JacksonDatabind/48,src_main_java_com_fasterxml_jackson_databind_DeserializationConfig,656,78,676,20,0,0,80,2,0,0,673,17,0,3,80,2,0,0
JacksonDatabind/48,src_main_java_com_fasterxml_jackson_databind_SerializationConfig,679,81,699,20,0,0,83,2,0,0,696,17,0,3,83,2,0,0
JacksonDatabind/49,src_main_java_com_fasterxml_jackson_databind_ser_impl_WritableObjectId,40,6,51,11,0,0,8,2,0,0,48,8,0,3,8,2,0,0
JacksonDatabind/5,src_main_java_com_fasterxml_jackson_databind_introspect_AnnotatedClass,721,64,750,29,0,0,66,2,0,0,745,24,0,5,66,2,0,0
JacksonDatabind/50,src_main_java_com_fasterxml_jackson_databind_deser_BeanDeserializer,647,29,747,100,0,0,32,3,0,0,730,83,6,17,32,3,0,0
JacksonDatabind/51,src_main_java_com_fasterxml_jackson_databind_jsontype_impl_TypeDeserializerBase,147,22,182,35,0,0,24,2,0,0,178,31,0,4,24,2,0,0
JacksonDatabind/52,src_main_java_com_fasterxml_jackson_databind_deser_BeanDeserializerBase,1007,83,1108,101,0,0,85,2,0,0,1105,98,0,3,85,2,0,0
JacksonDatabind/52,src_main_java_com_fasterxml_jackson_databind_deser_impl_ExternalTypeHandler,285,29,298,13,0,0,32,3,0,0,295,10,0,3,32,3,0,0
JacksonDatabind/53,src_main_java_com_fasterxml_jackson_databind_type_TypeBindings,288,39,311,23,0,0,41,2,0,0,309,21,0,2,41,2,0,0
JacksonDatabind/53,src_main_java_com_fasterxml_jackson_databind_type_TypeFactory,717,86,851,134,0,3,90,4,0,0,837,120,2,17,90,4,0,0
JacksonDatabind/54,src_main_java_com_fasterxml_jackson_databind_ser_PropertyBuilder,106,13,188,82,0,0,15,2,0,0,177,71,0,11,15,2,0,0
JacksonDatabind/55,src_main_java_com_fasterxml_jackson_databind_ser_std_StdKeySerializers,139,23,160,21,4,1,25,2,0,0,153,14,0,8,25,2,0,0
JacksonDatabind/56,src_main_java_com_fasterxml_jackson_databind_deser_std_FromStringDeserializer,153,23,229,76,0,0,26,3,0,0,220,67,0,9,26,3,0,0
JacksonDatabind/57,src_main_java_com_fasterxml_jackson_databind_ObjectReader,1244,133,1264,20,0,0,135,2,0,0,1257,13,0,7,135,2,0,0
JacksonDatabind/58,src_main_java_com_fasterxml_jackson_databind_deser_BeanDeserializerFactory,491,23,535,44,0,0,25,2,0,0,529,38,0,6,25,2,0,0
JacksonDatabind/59,src_main_java_com_fasterxml_jackson_databind_JavaType,348,61,355,7,0,0,62,1,0,0,355,7,0,0,62,1,0,0
JacksonDatabind/59,src_main_java_com_fasterxml_jackson_databind_type_CollectionLikeType,215,27,219,4,0,0,28,1,0,0,219,4,0,0,28,1,0,0
JacksonDatabind/59,src_main_java_com_fasterxml_jackson_databind_type_MapLikeType,240,31,244,4,0,0,32,1,0,0,244,4,0,0,32,1,0,0
JacksonDatabind/59,src_main_java_com_fasterxml_jackson_databind_type_TypeFactory,827,90,889,62,0,0,92,2,0,0,884,57,0,5,92,2,0,0
JacksonDatabind/60,src_main_java_com_fasterxml_jackson_databind_ser_std_JsonValueSerializer,185,15,232,47,0,0,17,2,0,0,223,38,1,9,17,2,0,0
JacksonDatabind/61,src_main_java_com_fasterxml_jackson_databind_ObjectMapper,2195,259,2232,37,0,0,264,5,0,0,2230,35,0,2,264,5,0,0
JacksonDatabind/61,src_main_java_com_fasterxml_jackson_databind_jsontype_impl_StdTypeResolverBuilder,102,17,162,60,0,0,20,3,0,0,152,50,0,10,20,3,0,0
JacksonDatabind/62,src_main_java_com_fasterxml_jackson_databind_deser_std_CollectionDeserializer,256,32,292,36,0,0,34,2,0,0,286,30,0,6,34,2,0,0
JacksonDatabind/63,src_main_java_com_fasterxml_jackson_databind_JsonMappingException,344,52,381,37,2,0,55,3,0,0,377,33,3,4,55,3,0,0
JacksonDatabind/65,src_main_java_com_fasterxml_jackson_databind_deser_std_StdKeyDeserializer,351,60,381,30,0,0,62,2,0,0,375,24,0,6,62,2,0,0
JacksonDatabind/65,src_main_java_com_fasterxml_jackson_databind_introspect_BasicBeanDescription,464,47,511,47,0,0,50,3,0,0,506,42,1,5,50,3,0,0
JacksonDatabind/66,src_main_java_com_fasterxml_jackson_databind_deser_std_StdKeyDeserializer,336,53,381,45,3,0,62,9,0,0,369,33,0,12,62,9,0,0
JacksonDatabind/67,src_main_java_com_fasterxml_jackson_databind_deser_BasicDeserializerFactory,1425,67,1479,54,0,0,69,2,0,0,1459,34,0,20,69,2,0,0
JacksonDatabind/69,src_main_java_com_fasterxml_jackson_databind_deser_impl_CreatorCollector,234,52,308,74,0,0,56,4,0,0,289,55,3,19,56,4,0,0
JacksonDatabind/7,src_main_java_com_fasterxml_jackson_databind_util_TokenBuffer,1589,162,1602,13,0,0,164,2,0,0,1598,9,0,4,164,2,0,0
JacksonDatabind/70,src_main_java_com_fasterxml_jackson_databind_deser_impl_BeanPropertyMap,402,33,431,29,0,0,35,2,0,0,430,28,0,1,35,2,0,0
JacksonDatabind/71,src_main_java_com_fasterxml_jackson_databind_deser_std_StdKeyDeserializer,297,60,367,70,0,0,62,2,0,0,364,67,0,3,62,2,0,0
JacksonDatabind/72,src_main_java_com_fasterxml_jackson_databind_deser_impl_InnerClassProperty,143,20,148,5,0,0,21,1,0,0,147,4,0,1,21,1,0,0
JacksonDatabind/73,src_main_java_com_fasterxml_jackson_databind_introspect_POJOPropertiesCollector,729,54,743,14,0,0,56,2,0,0,742,13,0,1,56,2,0,0
JacksonDatabind/73,src_main_java_com_fasterxml_jackson_databind_introspect_POJOPropertyBuilder,1052,112,1088,36,0,0,114,2,0,0,1087,35,0,1,114,2,0,0
JacksonDatabind/74,src_main_java_com_fasterxml_jackson_databind_jsontype_impl_AsPropertyTypeDeserializer,112,10,143,31,0,0,12,2,0,0,137,25,0,6,12,2,0,0
JacksonDatabind/75,src_main_java_com_fasterxml_jackson_databind_ser_std_EnumSerializer,96,10,153,57,0,0,14,4,0,0,137,41,0,16,14,4,0,0
JacksonDatabind/76,src_main_java_com_fasterxml_jackson_databind_deser_BuilderBasedDeserializer,544,27,595,51,0,0,29,2,0,0,588,44,0,7,29,2,0,0
JacksonDatabind/77,src_main_java_com_fasterxml_jackson_databind_deser_BeanDeserializerFactory,502,23,539,37,0,0,25,2,0,0,533,31,0,6,25,2,0,0
JacksonDatabind/78,src_main_java_com_fasterxml_jackson_databind_deser_BeanDeserializerFactory,523,23,560,37,0,0,25,2,0,0,554,31,0,6,25,2,0,0
JacksonDatabind/79,src_main_java_com_fasterxml_jackson_databind_introspect_JacksonAnnotationIntrospector,1087,93,1112,25,4,1,95,2,0,0,1099,12,4,14,95,2,0,0
JacksonDatabind/79,src_main_java_com_fasterxml_jackson_databind_introspect_ObjectIdInfo,80,16,91,11,0,0,18,2,0,0,87,7,0,4,18,2,0,0
JacksonDatabind/79,src_main_java_com_fasterxml_jackson_databind_ser_std_BeanSerializerBase,507,35,618,111,0,0,37,2,0,0,611,104,0,7,37,2,0,0
JacksonDatabind/8,src_main_java_com_fasterxml_jackson_databind_deser_impl_CreatorCollector,259,49,287,28,0,0,51,2,0,0,282,23,1,5,51,2,0,0
JacksonDatabind/80,src_main_java_com_fasterxml_jackson_databind_jsontype_impl_StdSubtypeResolver,146,10,212,66,0,0,13,3,0,0,198,52,4,14,13,3,0,0
JacksonDatabind/81,src_main_java_com_fasterxml_jackson_databind_introspect_JacksonAnnotationIntrospector,1089,94,1229,140,0,0,97,3,0,0,1206,117,0,23,97,3,0,0
JacksonDatabind/82,src_main_java_com_fasterxml_jackson_databind_deser_BeanDeserializerFactory,466,26,586,120,0,0,28,2,0,0,570,104,0,16,28,2,0,0
JacksonDatabind/83,src_main_java_com_fasterxml_jackson_databind_deser_std_FromStringDeserializer,188,26,243,55,0,0,28,2,0,0,236,48,0,7,28,2,0,0
JacksonDatabind/84,src_main_java_com_fasterxml_jackson_databind_type_ResolvedRecursiveType,125,18,129,4,0,0,19,1,0,0,129,4,0,0,19,1,0,0
JacksonDatabind/86,src_main_java_com_fasterxml_jackson_databind_type_ResolvedRecursiveType,125,18,129,4,0,0,19,1,0,0,129,4,0,0,19,1,0,0
JacksonDatabind/87,src_main_java_com_fasterxml_jackson_databind_util_StdDateFormat,293,43,422,129,0,0,47,4,0,0,405,112,0,17,47,4,0,0
JacksonDatabind/88,src_main_java_com_fasterxml_jackson_databind_jsontype_impl_ClassNameIdResolver,89,8,118,29,0,0,10,2,0,0,114,25,0,4,10,2,0,0
JacksonDatabind/89,src_main_java_com_fasterxml_jackson_databind_deser_BeanDeserializerFactory,568,27,586,18,0,0,28,1,0,0,573,5,0,13,28,1,0,0
JacksonDatabind/90,src_main_java_com_fasterxml_jackson_databind_deser_ValueInstantiator,231,36,240,9,0,0,38,2,0,0,240,9,0,0,38,2,0,0
JacksonDatabind/90,src_main_java_com_fasterxml_jackson_databind_deser_std_StdValueInstantiator,442,62,448,6,0,0,63,1,0,0,447,5,0,1,63,1,0,0
JacksonDatabind/91,src_main_java_com_fasterxml_jackson_databind_deser_DeserializerCache,334,22,352,18,0,0,24,2,0,0,347,13,0,5,24,2,0,0
JacksonDatabind/92,src_main_java_com_fasterxml_jackson_databind_deser_BeanDeserializerFactory,547,27,565,18,0,0,28,1,0,0,552,5,0,13,28,1,0,0
JacksonDatabind/93,src_main_java_com_fasterxml_jackson_databind_jsontype_impl_SubTypeValidator,9,6,59,50,0,0,8,2,0,0,36,27,0,23,8,2,0,0
JacksonDatabind/94,src_main_java_com_fasterxml_jackson_databind_jsontype_impl_SubTypeValidator,9,6,58,49,0,0,8,2,0,0,37,28,0,21,8,2,0,0
JacksonDatabind/95,src_main_java_com_fasterxml_jackson_databind_type_TypeFactory,876,91,942,66,2,2,94,3,0,0,934,58,2,10,94,3,0,0
JacksonDatabind/95,src_main_java_com_fasterxml_jackson_databind_type_TypeParser,111,18,135,24,0,0,20,2,0,0,132,21,0,3,20,2,0,0
JacksonDatabind/96,src_main_java_com_fasterxml_jackson_databind_deser_BasicDeserializerFactory,1535,69,1595,60,0,0,71,2,0,0,1575,40,0,20,71,2,0,0
JacksonDatabind/97,src_main_java_com_fasterxml_jackson_databind_node_POJONode,126,16,146,20,0,3,18,2,0,0,141,15,0,8,18,2,0,0
JacksonDatabind/98,src_main_java_com_fasterxml_jackson_databind_deser_impl_ExternalTypeHandler,341,36,391,50,0,0,38,2,0,0,384,43,1,7,38,2,0,0
JacksonDatabind/99,src_main_java_com_fasterxml_jackson_databind_type_ReferenceType,209,26,223,14,0,0,28,2,0,0,221,12,0,2,28,2,0,0
JacksonXml/1,src_main_java_com_fasterxml_jackson_dataformat_xml_deser_FromXmlParser,549,68,657,108,0,0,70,2,0,0,652,103,2,5,70,2,0,0
JacksonXml/2,src_main_java_com_fasterxml_jackson_dataformat_xml_deser_XmlTokenStream,292,44,333,41,0,0,46,2,0,0,330,38,0,3,46,2,0,0
JacksonXml/3,src_main_java_com_fasterxml_jackson_dataformat_xml_deser_FromXmlParser,577,68,661,84,0,0,70,2,0,0,657,80,0,4,70,2,0,0
JacksonXml/4,src_main_java_com_fasterxml_jackson_dataformat_xml_ser_XmlSerializerProvider,213,13,228,15,0,0,15,2,0,0,223,10,0,5,15,2,0,0
JacksonXml/5,src_main_java_com_fasterxml_jackson_dataformat_xml_ser_XmlSerializerProvider,191,15,201,10,0,0,17,2,0,0,199,8,0,2,17,2,0,0
JacksonXml/6,src_main_java_com_fasterxml_jackson_dataformat_xml_ser_ToXmlGenerator,1020,84,1025,5,0,0,85,1,0,0,1024,4,0,1,85,1,0,0
Jsoup/1,src_main_java_org_jsoup_nodes_Document,85,11,109,24,0,0,13,2,0,0,104,19,4,5,13,2,0,0
Jsoup/10,src_main_java_org_jsoup_nodes_Node,339,52,368,29,0,0,54,2,0,0,366,27,0,2,54,2,0,0
Jsoup/11,src_main_java_org_jsoup_select_Selector,295,31,373,78,0,0,34,3,0,0,371,76,0,2,34,3,0,0
Jsoup/12,src_main_java_org_jsoup_select_Selector,384,34,406,22,0,0,36,2,0,0,404,20,0,2,36,2,0,0
Jsoup/13,src_main_java_org_jsoup_nodes_Node,433,59,445,12,0,0,61,2,0,0,444,11,0,1,61,2,0,0
Jsoup/14,src_main_java_org_jsoup_parser_Tokeniser,200,39,202,2,0,0,40,1,0,0,202,2,0,0,40,1,0,0
Jsoup/14,src_main_java_org_jsoup_parser_TokeniserState,1711,72,1723,12,0,0,74,2,0,0,1711,0,0,12,73,1,0,1
Jsoup/15,src_main_java_org_jsoup_parser_TreeBuilderState,1075,41,1587,512,0,0,43,2,0,0,1075,0,0,512,42,1,0,1
Jsoup/16,src_main_java_org_jsoup_nodes_DocumentType,13,2,43,30,0,0,5,3,0,0,32,19,0,11,5,3,0,0
Jsoup/17,src_main_java_org_jsoup_parser_TreeBuilderState,1587,41,1587,0,0,0,43,2,0,0,1587,0,0,0,43,2,0,0
Jsoup/18,src_main_java_org_jsoup_parser_CharacterReader,184,30,199,15,0,0,33,3,0,0,197,13,0,2,33,3,0,0
Jsoup/19,src_main_java_org_jsoup_safety_Whitelist,269,37,289,20,0,0,39,2,0,0,286,17,0,3,39,2,0,0
Jsoup/2,src_main_java_org_jsoup_parser_Parser,217,26,262,45,0,0,28,2,0,0,262,45,0,0,28,2,0,0
Jsoup/20,src_main_java_org_jsoup_helper_DataUtil,73,9,108,35,0,0,11,2,0,0,103,30,0,5,11,2,0,0
Jsoup/23,src_main_java_org_jsoup_parser_CharacterReader,197,32,199,2,0,0,33,1,0,0,199,2,0,0,33,1,0,0
Jsoup/23,src_main_java_org_jsoup_parser_Tokeniser,139,36,202,63,0,0,38,2,0,0,199,60,0,3,38,2,0,0
Jsoup/24,src_main_java_org_jsoup_parser_TokeniserState,1704,75,1738,34,0,0,77,2,0,0,1704,0,0,34,76,1,0,1
Jsoup/25,src_main_java_org_jsoup_parser_Tag,142,31,174,32,0,0,33,2,0,0,145,3,0,29,33,2,0,0
Jsoup/26,src_main_java_org_jsoup_safety_Cleaner,72,9,84,12,0,0,11,2,0,0,82,10,0,2,11,2,0,0
Jsoup/27,src_main_java_org_jsoup_helper_DataUtil,95,9,112,17,0,0,11,2,0,0,110,15,0,2,11,2,0,0
Jsoup/28,src_main_java_org_jsoup_nodes_Entities,96,20,116,20,2,0,22,2,0,0,102,6,0,14,22,2,0,0
Jsoup/28,src_main_java_org_jsoup_parser_Parser,97,17,100,3,0,0,18,1,0,0,100,3,0,0,18,1,0,0
Jsoup/28,src_main_java_org_jsoup_parser_Tokeniser,141,36,196,55,0,1,38,2,0,0,191,50,1,6,38,2,0,0
Jsoup/29,src_main_java_org_jsoup_nodes_Document,254,39,265,11,0,0,41,2,0,0,264,10,0,1,41,2,0,0
Jsoup/3,src_main_java_org_jsoup_nodes_Element,518,65,573,55,0,0,69,4,0,0,567,49,0,6,69,4,0,0
Jsoup/3,src_main_java_org_jsoup_parser_Parser,195,24,265,70,0,0,28,4,0,0,260,65,0,5,28,4,0,0
Jsoup/3,src_main_java_org_jsoup_parser_Tag,181,32,320,139,0,0,35,3,0,0,207,26,3,113,34,2,1,1
Jsoup/31,src_main_java_org_jsoup_parser_Token,239,63,246,7,0,0,65,2,0,0,245,6,0,1,65,2,0,0
Jsoup/31,src_main_java_org_jsoup_parser_TokeniserState,1751,75,1761,10,0,0,77,2,0,0,1751,0,0,10,76,1,0,1
Jsoup/31,src_main_java_org_jsoup_parser_XmlTreeBuilder,97,7,108,11,0,0,9,2,0,0,107,10,0,1,9,2,0,0
Jsoup/33,src_main_java_org_jsoup_parser_HtmlTreeBuilder,683,85,699,16,0,0,87,2,0,0,697,14,0,2,87,2,0,0
Jsoup/34,src_main_java_org_jsoup_parser_CharacterReader,236,34,258,22,0,0,36,2,0,0,257,21,0,1,36,2,0,0
Jsoup/35,src_main_java_org_jsoup_parser_HtmlTreeBuilderState,1076,41,1587,511,0,0,43,2,0,0,1076,0,0,511,42,1,0,1
Jsoup/36,src_main_java_org_jsoup_helper_DataUtil,79,8,139,60,0,0,12,4,0,0,132,53,0,7,12,4,0,0
Jsoup/37,src_main_java_org_jsoup_nodes_Element,762,92,774,12,0,0,94,2,0,0,773,11,0,1,94,2,0,0
Jsoup/38,src_main_java_org_jsoup_parser_HtmlTreeBuilderState,1081,59,1593,512,0,0,61,2,0,0,1081,0,0,512,60,1,0,1
Jsoup/39,src_main_java_org_jsoup_helper_DataUtil,103,10,159,56,0,0,12,2,0,0,154,51,0,5,12,2,0,0
Jsoup/4,src_main_java_org_jsoup_nodes_Entities,25,9,76,51,0,0,11,2,0,0,59,34,0,17,11,2,0,0
Jsoup/40,src_main_java_org_jsoup_nodes_DocumentType,28,3,43,15,0,0,5,2,0,0,39,11,0,4,5,2,0,0
Jsoup/41,src_main_java_org_jsoup_nodes_Element,780,92,798,18,0,0,94,2,0,0,795,15,0,3,94,2,0,0
Jsoup/42,src_main_java_org_jsoup_nodes_FormElement,35,6,75,40,0,0,8,2,0,0,74,39,0,1,8,2,0,0
Jsoup/43,src_main_java_org_jsoup_nodes_Element,780,93,802,22,0,0,95,2,0,0,795,15,0,7,95,2,0,0
Jsoup/44,src_main_java_org_jsoup_parser_TreeBuilder,52,15,76,24,0,0,19,4,0,0,72,20,0,4,19,4,0,0
Jsoup/45,src_main_java_org_jsoup_parser_HtmlTreeBuilder,626,97,690,64,1,1,99,2,0,0,690,64,1,1,99,2,0,0
Jsoup/46,src_main_java_org_jsoup_nodes_Entities,120,22,199,79,5,5,24,2,0,0,183,63,5,21,24,2,0,0
Jsoup/47,src_main_java_org_jsoup_nodes_Entities,120,22,202,82,3,3,24,2,0,0,183,63,4,22,24,2,0,0
Jsoup/48,src_main_java_org_jsoup_helper_HttpConnection,981,141,1015,34,0,0,146,5,0,0,1010,29,0,5,146,5,0,0
Jsoup/49,src_main_java_org_jsoup_nodes_Node,499,68,518,19,0,0,70,2,0,0,516,17,0,2,70,2,0,0
Jsoup/5,src_main_java_org_jsoup_parser_Parser,248,28,281,33,0,0,30,2,0,0,280,32,0,1,30,2,0,0
Jsoup/50,src_main_java_org_jsoup_helper_DataUtil,138,17,188,50,2,0,19,2,0,0,182,44,0,6,19,2,0,0
Jsoup/51,src_main_java_org_jsoup_parser_CharacterReader,340,42,350,10,0,0,44,2,0,0,349,9,0,1,44,2,0,0
Jsoup/52,src_main_java_org_jsoup_helper_DataUtil,170,19,221,51,0,0,21,2,0,0,214,44,1,7,21,2,0,0
Jsoup/52,src_main_java_org_jsoup_nodes_XmlDeclaration,32,7,49,17,0,0,10,3,0,0,44,12,0,5,10,3,0,0
Jsoup/52,src_main_java_org_jsoup_parser_XmlTreeBuilder,102,8,119,17,0,0,10,2,0,0,118,16,0,1,10,2,0,0
Jsoup/53,src_main_java_org_jsoup_parser_TokenQueue,257,34,288,31,0,0,36,2,0,0,285,28,0,3,36,2,0,0
Jsoup/54,src_main_java_org_jsoup_helper_W3CDom,113,13,131,18,0,0,16,3,0,0,128,15,0,3,16,3,0,0
Jsoup/55,src_main_java_org_jsoup_parser_TokeniserState,1675,81,1699,24,0,0,83,2,0,0,1675,0,0,24,82,1,0,1
Jsoup/56,src_main_java_org_jsoup_nodes_DocumentType,13,7,55,42,0,0,11,4,0,0,44,31,0,11,11,4,0,0
Jsoup/56,src_main_java_org_jsoup_parser_HtmlTreeBuilderState,1583,60,1606,23,0,0,62,2,0,0,1583,0,0,23,61,1,0,1
Jsoup/56,src_main_java_org_jsoup_parser_Token,361,79,378,17,0,0,82,3,0,0,374,13,0,4,82,3,0,0
Jsoup/56,src_main_java_org_jsoup_parser_TokeniserState,1667,81,1700,33,0,0,83,2,0,0,1667,0,0,33,82,1,0,1
Jsoup/56,src_main_java_org_jsoup_parser_XmlTreeBuilder,124,10,134,10,0,0,12,2,0,0,133,9,0,1,12,2,0,0
Jsoup/57,src_main_java_org_jsoup_nodes_Attributes,257,35,272,15,0,2,37,2,0,0,271,14,0,3,37,2,0,0
Jsoup/58,src_main_java_org_jsoup_Jsoup,134,15,147,13,0,0,17,2,0,0,142,8,0,5,17,2,0,0
Jsoup/58,src_main_java_org_jsoup_parser_Parser,130,22,133,3,0,0,23,1,0,0,133,3,0,0,23,1,0,0
Jsoup/58,src_main_java_org_jsoup_safety_Cleaner,106,16,119,13,0,0,18,2,0,0,118,12,0,1,18,2,0,0
Jsoup/59,src_main_java_org_jsoup_parser_Token,355,81,384,29,0,0,84,3,0,0,383,28,0,1,84,3,0,0
Jsoup/6,src_main_java_org_jsoup_nodes_Entities,25,9,73,48,4,2,11,2,0,0,58,33,4,17,11,2,0,0
Jsoup/60,src_main_java_org_jsoup_parser_TokenQueue,257,34,294,37,0,0,36,2,0,0,291,34,0,3,36,2,0,0
Jsoup/60,src_main_java_org_jsoup_select_QueryParser,313,27,324,11,0,0,29,2,0,0,322,9,0,2,29,2,0,0
Jsoup/61,src_main_java_org_jsoup_nodes_Element,811,96,851,40,0,0,98,2,0,0,850,39,0,1,98,2,0,0
Jsoup/62,src_main_java_org_jsoup_parser_HtmlTreeBuilderState,1583,60,1607,24,0,0,62,2,0,0,1583,0,0,24,61,1,0,1
Jsoup/64,src_main_java_org_jsoup_parser_HtmlTreeBuilderState,1594,60,1605,11,0,0,62,2,0,0,1603,9,0,2,62,2,0,0
Jsoup/65,src_main_java_org_jsoup_parser_HtmlTreeBuilder,693,96,705,12,0,0,99,3,0,0,705,12,0,0,99,3,0,0
Jsoup/65,src_main_java_org_jsoup_parser_HtmlTreeBuilderState,1490,57,1606,116,0,0,62,5,0,0,1490,0,0,116,58,1,0,4
Jsoup/66,src_main_java_org_jsoup_nodes_Element,924,112,961,37,0,0,118,6,0,0,954,30,0,7,118,6,0,0
Jsoup/67,src_main_java_org_jsoup_parser_HtmlTreeBuilder,682,97,706,24,0,0,99,2,0,0,703,21,0,3,99,2,0,0
Jsoup/68,src_main_java_org_jsoup_parser_HtmlTreeBuilder,682,98,705,23,0,0,100,2,0,0,702,20,0,3,100,2,0,0
Jsoup/69,src_main_java_org_jsoup_nodes_FormElement,64,6,68,4,0,0,7,1,0,0,68,4,0,0,7,1,0,0
Jsoup/7,src_main_java_org_jsoup_nodes_Document,177,31,196,19,0,0,33,2,0,0,195,18,0,1,33,2,0,0
Jsoup/70,src_main_java_org_jsoup_nodes_Element,960,118,976,16,0,0,120,2,0,0,974,14,0,2,120,2,0,0
Jsoup/71,src_main_java_org_jsoup_select_Evaluator,908,153,912,4,0,0,154,1,0,0,912,4,0,0,154,1,0,0
Jsoup/71,src_main_java_org_jsoup_select_QueryParser,266,27,328,62,0,0,29,2,0,0,328,62,0,0,29,2,0,0
Jsoup/72,src_main_java_org_jsoup_parser_CharacterReader,378,50,412,34,0,0,52,2,0,0,406,28,0,6,52,2,0,0
Jsoup/73,src_main_java_org_jsoup_helper_W3CDom,53,9,135,82,1,1,16,7,0,0,123,70,0,13,15,6,0,1
Jsoup/74,src_main_java_org_jsoup_helper_StringUtil,172,18,201,29,0,0,20,2,0,0,197,25,0,4,20,2,0,0
Jsoup/75,src_main_java_org_jsoup_nodes_Attributes,354,56,377,23,0,0,58,2,0,0,371,17,0,6,58,2,0,0
Jsoup/76,src_main_java_org_jsoup_parser_HtmlTreeBuilderState,1095,60,1611,516,0,0,62,2,0,0,1095,0,0,516,61,1,0,1
Jsoup/77,src_main_java_org_jsoup_parser_XmlTreeBuilder,114,11,141,27,0,0,13,2,0,0,140,26,0,1,13,2,0,0
Jsoup/78,src_main_java_org_jsoup_helper_DataUtil,161,23,227,66,0,0,25,2,0,0,220,59,0,7,25,2,0,0
Jsoup/79,src_main_java_org_jsoup_nodes_LeafNode,101,14,110,9,0,0,16,2,0,0,108,7,0,2,16,2,0,0
Jsoup/8,src_main_java_org_jsoup_nodes_Node,327,49,338,11,0,0,51,2,0,0,337,10,0,1,51,2,0,0
Jsoup/80,src_main_java_org_jsoup_parser_XmlTreeBuilder,120,11,140,20,0,0,13,2,0,0,139,19,0,1,13,2,0,0
Jsoup/81,src_main_java_org_jsoup_helper_DataUtil,161,23,236,75,0,0,25,2,0,0,229,68,0,7,25,2,0,0
Jsoup/82,src_main_java_org_jsoup_helper_DataUtil,138,21,219,81,0,0,23,2,0,0,212,74,0,7,23,2,0,0
Jsoup/84,src_main_java_org_jsoup_helper_W3CDom,90,13,136,46,0,0,16,3,0,0,133,43,0,3,16,3,0,0
Jsoup/86,src_main_java_org_jsoup_nodes_Comment,49,9,68,19,0,0,11,2,0,0,67,18,0,1,11,2,0,0
Jsoup/87,src_main_java_org_jsoup_nodes_Element,1019,123,1023,4,0,0,124,1,0,0,1023,4,0,0,124,1,0,0
Jsoup/87,src_main_java_org_jsoup_parser_HtmlTreeBuilder,488,84,716,228,0,0,98,14,0,0,700,212,0,16,98,14,0,0
Jsoup/87,src_main_java_org_jsoup_parser_HtmlTreeBuilderState,635,54,1648,1013,0,1,66,12,0,0,635,0,0,1014,55,1,0,11
Jsoup/87,src_main_java_org_jsoup_parser_Tag,154,37,199,45,0,0,39,2,0,0,161,7,0,38,39,2,0,0
Jsoup/88,src_main_java_org_jsoup_nodes_Attribute,172,23,181,9,0,0,25,2,0,0,180,8,0,1,25,2,0,0
Jsoup/89,src_main_java_org_jsoup_nodes_Attribute,164,23,182,18,0,0,25,2,0,0,179,15,0,3,25,2,0,0
Jsoup/9,src_main_java_org_jsoup_nodes_Entities,66,14,88,22,0,0,16,2,0,0,70,4,0,18,16,2,0,0
Jsoup/90,src_main_java_org_jsoup_helper_HttpConnection,1210,171,1256,46,0,0,174,3,0,0,1253,43,0,3,174,3,0,0
Jsoup/91,src_main_java_org_jsoup_UncheckedIOException,10,2,14,4,0,0,3,1,0,0,14,4,0,0,3,1,0,0
Jsoup/91,src_main_java_org_jsoup_parser_CharacterReader,432,50,452,20,0,0,53,3,0,0,447,15,0,5,53,3,0,0
Jsoup/92,src_main_java_org_jsoup_nodes_Attributes,358,55,374,16,0,0,58,3,0,0,371,13,0,3,58,3,0,0
Jsoup/92,src_main_java_org_jsoup_parser_HtmlTreeBuilder,682,96,700,18,0,0,98,2,0,0,698,16,0,2,98,2,0,0
Jsoup/92,src_main_java_org_jsoup_parser_ParseSettings,38,9,44,6,0,0,10,1,0,0,41,3,0,3,10,1,0,0
Jsoup/92,src_main_java_org_jsoup_parser_Token,375,85,407,32,0,0,88,3,0,0,406,31,0,1,88,3,0,0
Jsoup/92,src_main_java_org_jsoup_parser_XmlTreeBuilder,124,12,142,18,0,0,14,2,0,0,140,16,0,2,14,2,0,0
Jsoup/93,src_main_java_org_jsoup_nodes_FormElement,35,6,76,41,0,0,8,2,0,0,75,40,0,1,8,2,0,0
JxPath/1,src_java_org_apache_commons_jxpath_ri_model_dom_DOMNodePointer,638,49,691,53,0,0,51,2,0,0,689,51,0,2,51,2,0,0
JxPath/1,src_java_org_apache_commons_jxpath_ri_model_jdom_JDOMNodePointer,642,45,693,51,0,2,47,2,0,0,690,48,0,5,47,2,0,0
JxPath/10,src_java_org_apache_commons_jxpath_ri_compiler_CoreOperationRelationalExpression,95,8,109,14,0,0,10,2,0,0,107,12,0,2,10,2,0,0
JxPath/11,src_java_org_apache_commons_jxpath_ri_model_dom_DOMAttributeIterator,93,10,124,31,0,0,12,2,0,0,119,26,2,5,12,2,0,0
JxPath/11,src_java_org_apache_commons_jxpath_ri_model_jdom_JDOMAttributeIterator,30,6,77,47,0,0,8,2,0,0,73,43,2,4,8,2,0,0
JxPath/12,src_java_org_apache_commons_jxpath_ri_model_dom_DOMNodePointer,610,50,664,54,0,0,52,2,0,0,662,52,0,2,52,2,0,0
JxPath/14,src_java_org_apache_commons_jxpath_ri_compiler_CoreFunction,681,42,709,28,0,0,46,4,0,0,703,22,0,6,46,4,0,0
JxPath/15,src_java_org_apache_commons_jxpath_ri_axes_UnionContext,12,4,39,27,0,0,6,2,0,0,38,26,0,1,6,2,0,0
JxPath/16,src_java_org_apache_commons_jxpath_ri_model_dom_DOMNodePointer,638,52,690,52,0,1,54,2,0,0,688,50,0,3,54,2,0,0
JxPath/16,src_java_org_apache_commons_jxpath_ri_model_jdom_JDOMNodePointer,655,48,705,50,0,1,50,2,0,0,702,47,0,4,50,2,0,0
JxPath/18,src_java_org_apache_commons_jxpath_ri_axes_AttributeContext,33,8,59,26,0,1,10,2,0,0,55,22,1,5,10,2,0,0
JxPath/19,src_java_org_apache_commons_jxpath_ri_model_dom_DOMNodePointer,632,50,652,20,0,0,52,2,0,0,648,16,2,4,52,2,0,0
JxPath/19,src_java_org_apache_commons_jxpath_ri_model_jdom_JDOMNodePointer,652,46,682,30,0,0,48,2,0,0,682,30,0,0,48,2,0,0
JxPath/2,src_java_org_apache_commons_jxpath_ri_compiler_Expression,82,23,109,27,0,0,26,3,0,0,105,23,0,4,26,3,0,0
JxPath/20,src_java_org_apache_commons_jxpath_ri_compiler_CoreOperationRelationalExpression,70,8,107,37,0,0,10,2,0,0,104,34,0,3,10,2,0,0
JxPath/21,src_java_org_apache_commons_jxpath_ri_model_beans_PropertyPointer,171,27,183,12,0,0,29,2,0,0,180,9,0,3,29,2,0,0
JxPath/22,src_java_org_apache_commons_jxpath_ri_model_dom_DOMNodePointer,627,51,658,31,0,1,53,2,0,0,655,28,1,4,53,2,0,0
JxPath/3,src_java_org_apache_commons_jxpath_ri_model_beans_NullPropertyPointer,153,24,190,37,0,0,27,3,0,0,185,32,0,5,27,3,0,0
JxPath/5,src_java_org_apache_commons_jxpath_ri_model_NodePointer,444,64,478,34,0,0,66,2,0,0,473,29,0,5,66,2,0,0
JxPath/6,src_java_org_apache_commons_jxpath_ri_compiler_CoreOperationCompare,65,4,103,38,0,2,6,2,0,0,100,35,0,5,6,2,0,0
JxPath/7,src_java_org_apache_commons_jxpath_ri_compiler_CoreOperationGreaterThan,11,2,15,4,0,0,3,1,0,0,15,4,0,0,3,1,0,0
JxPath/7,src_java_org_apache_commons_jxpath_ri_compiler_CoreOperationGreaterThanOrEqual,11,2,15,4,0,0,3,1,0,0,15,4,0,0,3,1,0,0
JxPath/7,src_java_org_apache_commons_jxpath_ri_compiler_CoreOperationLessThan,11,2,15,4,0,0,3,1,0,0,15,4,0,0,3,1,0,0
JxPath/7,src_java_org_apache_commons_jxpath_ri_compiler_CoreOperationLessThanOrEqual,11,2,15,4,0,0,3,1,0,0,15,4,0,0,3,1,0,0
JxPath/7,src_java_org_apache_commons_jxpath_ri_compiler_CoreOperationRelationalExpression,17,3,22,5,0,0,4,1,0,0,22,5,0,0,4,1,0,0
JxPath/8,src_java_org_apache_commons_jxpath_ri_compiler_CoreOperationRelationalExpression,70,8,101,31,0,0,10,2,0,0,99,29,0,2,10,2,0,0
Lang/1,src_main_java_org_apache_commons_lang3_math_NumberUtils,684,65,829,145,0,0,67,2,0,0,826,142,0,3,67,2,0,0
Lang/10,src_main_java_org_apache_commons_lang3_time_FastDateParser,572,95,614,42,0,0,97,2,0,0,610,38,0,4,97,2,0,0
Lang/11,src_main_java_org_apache_commons_lang3_RandomStringUtils,93,12,167,74,0,0,14,2,0,0,159,66,0,8,14,2,0,0
Lang/12,src_main_java_org_apache_commons_lang3_RandomStringUtils,93,12,160,67,0,0,14,2,0,0,151,58,1,9,14,2,0,0
Lang/13,src_main_java_org_apache_commons_lang3_SerializationUtils,103,7,132,29,0,0,11,4,0,0,122,19,0,10,11,4,0,0
Lang/14,src_main_java_org_apache_commons_lang3_StringUtils,2894,177,2911,17,0,0,179,2,0,0,2909,15,0,2,179,2,0,0
Lang/15,src_main_java_org_apache_commons_lang3_reflect_TypeUtils,530,26,591,61,0,4,29,3,0,0,584,54,0,11,29,3,0,0
Lang/16,src_main_java_org_apache_commons_lang3_math_NumberUtils,709,64,836,127,0,0,66,2,0,0,833,124,0,3,66,2,0,0
Lang/17,src_main_java_org_apache_commons_lang3_text_translate_CharSequenceTranslator,41,4,72,31,0,0,6,2,0,0,66,25,1,6,6,2,0,0
Lang/18,src_main_java_org_apache_commons_lang3_time_FastDateFormat,845,143,969,124,0,0,145,2,0,0,961,116,4,8,145,2,0,0
Lang/19,src_main_java_org_apache_commons_lang3_text_translate_NumericEntityUnescaper,0,0,52,52,0,0,2,2,0,0,41,41,0,11,2,2,0,0
Lang/20,src_main_java_org_apache_commons_lang3_StringUtils,2821,174,2902,81,0,6,177,3,0,0,2867,46,0,41,177,3,0,0
Lang/21,src_main_java_org_apache_commons_lang3_time_DateUtils,826,79,842,16,0,0,81,2,0,0,840,14,0,2,81,2,0,0
Lang/22,src_main_java_org_apache_commons_lang3_math_Fraction,472,51,517,45,0,0,53,2,0,0,514,42,0,3,53,2,0,0
Lang/23,src_main_java_org_apache_commons_lang3_text_ExtendedMessageFormat,312,28,316,4,0,0,29,1,0,0,316,4,0,0,29,1,0,0
Lang/24,src_main_java_org_apache_commons_lang3_math_NumberUtils,749,64,838,89,0,0,66,2,0,0,837,88,0,1,66,2,0,0
Lang/26,src_main_java_org_apache_commons_lang3_time_FastDateFormat,1117,160,1129,12,0,0,162,2,0,0,1127,10,0,2,162,2,0,0
Lang/27,src_main_java_org_apache_commons_lang3_math_NumberUtils,711,64,836,125,0,0,66,2,0,0,829,118,4,7,66,2,0,0
Lang/28,src_main_java_org_apache_commons_lang3_text_translate_NumericEntityUnescaper,0,0,39,39,0,0,2,2,0,0,34,34,0,5,2,2,0,0
Lang/29,src_main_java_org_apache_commons_lang3_SystemUtils,216,100,225,9,0,0,102,2,0,0,224,8,0,1,102,2,0,0
Lang/3,src_main_java_org_apache_commons_lang3_math_NumberUtils,684,65,823,139,0,0,67,2,0,0,818,134,2,5,67,2,0,0
Lang/30,src_main_java_org_apache_commons_lang3_StringUtils,2587,155,2718,131,3,1,162,7,0,0,2699,112,1,20,162,7,0,0
Lang/31,src_main_java_org_apache_commons_lang3_StringUtils,2674,160,2698,24,0,0,162,2,0,0,2696,22,0,2,162,2,0,0
Lang/32,src_main_java_org_apache_commons_lang3_builder_HashCodeBuilder,374,35,399,25,0,0,40,5,0,0,393,19,0,6,40,5,0,0
Lang/33,src_main_java_org_apache_commons_lang3_ClassUtils,540,43,587,47,0,0,45,2,0,0,559,19,0,28,45,2,0,0
Lang/34,src_main_java_org_apache_commons_lang3_builder_ToStringStyle,1232,156,1251,19,0,0,159,3,0,0,1249,17,0,2,159,3,0,0
Lang/35,src_main_java_org_apache_commons_lang3_ArrayUtils,2435,193,2476,41,0,0,196,3,0,0,2465,30,0,11,196,3,0,0
Lang/36,src_java_org_apache_commons_lang3_math_NumberUtils,625,63,830,205,0,0,66,3,0,0,826,201,0,4,66,3,0,0
Lang/37,src_java_org_apache_commons_lang3_ArrayUtils,2433,193,2456,23,0,0,195,2,0,0,2451,18,0,5,195,2,0,0
Lang/38,src_java_org_apache_commons_lang3_time_FastDateFormat,1113,160,1128,15,0,0,162,2,0,0,1125,12,0,3,162,2,0,0
Lang/39,src_java_org_apache_commons_lang3_StringUtils,2484,153,2572,88,0,0,155,2,0,0,2566,82,0,6,155,2,0,0
Lang/4,src_main_java_org_apache_commons_lang3_text_translate_LookupTranslator,0,2,51,51,0,0,6,4,0,0,45,45,0,6,6,4,0,0
Lang/40,src_java_org_apache_commons_lang_StringUtils,2515,152,2528,13,0,0,154,2,0,0,2526,11,0,2,154,2,0,0
Lang/41,src_java_org_apache_commons_lang_ClassUtils,505,42,569,64,0,0,45,3,0,0,537,32,0,32,45,3,0,0
Lang/43,src_java_org_apache_commons_lang_text_ExtendedMessageFormat,276,27,309,33,0,0,29,2,0,0,304,28,0,5,29,2,0,0
Lang/44,src_java_org_apache_commons_lang_NumberUtils,283,18,408,125,0,0,20,2,0,0,404,121,0,4,20,2,0,0
Lang/45,src_java_org_apache_commons_lang_WordUtils,240,13,280,40,0,0,15,2,0,0,275,35,0,5,15,2,0,0
Lang/46,src_java_org_apache_commons_lang_StringEscapeUtils,329,23,464,135,0,0,30,7,0,0,447,118,0,17,30,7,0,0
Lang/47,src_java_org_apache_commons_lang_text_StrBuilder,1639,161,1689,50,0,0,164,3,0,0,1681,42,0,8,164,3,0,0
Lang/48,src_java_org_apache_commons_lang_builder_EqualsBuilder,439,29,492,53,0,0,31,2,0,0,489,50,0,3,31,2,0,0
Lang/49,src_java_org_apache_commons_lang_math_Fraction,492,51,507,15,0,0,53,2,0,0,505,13,0,2,53,2,0,0
Lang/50,src_java_org_apache_commons_lang_time_FastDateFormat,1055,160,1118,63,0,0,163,3,0,0,1103,48,2,15,163,3,0,0
Lang/51,src_java_org_apache_commons_lang_BooleanUtils,439,36,479,40,0,0,38,2,0,0,478,39,0,1,38,2,0,0
Lang/52,src_java_org_apache_commons_lang_StringEscapeUtils,298,20,379,81,0,0,22,2,0,0,374,76,1,5,22,2,0,0
Lang/53,src_java_org_apache_commons_lang_time_DateUtils,389,49,484,95,0,0,51,2,0,0,481,92,0,3,51,2,0,0
Lang/54,src_java_org_apache_commons_lang_LocaleUtils,105,12,149,44,0,0,14,2,0,0,144,39,0,5,14,2,0,0
Lang/55,src_java_org_apache_commons_lang_time_StopWatch,94,21,106,12,0,0,23,2,0,0,106,12,0,0,23,2,0,0
Lang/56,src_java_org_apache_commons_lang_time_FastDateFormat,1109,159,1113,4,0,0,162,3,0,0,1113,4,0,0,162,3,0,0
Lang/57,src_java_org_apache_commons_lang_LocaleUtils,136,12,149,13,0,0,14,2,0,0,145,9,0,4,14,2,0,0
Lang/58,src_java_org_apache_commons_lang_math_NumberUtils,842,70,970,128,0,0,72,2,0,0,967,125,0,3,72,2,0,0
Lang/59,src_java_org_apache_commons_lang_text_StrBuilder,1492,140,1517,25,3,3,142,2,0,0,1511,19,5,9,142,2,0,0
Lang/6,src_main_java_org_apache_commons_lang3_text_translate_CharSequenceTranslator,41,4,74,33,0,0,6,2,0,0,71,30,0,3,6,2,0,0
Lang/60,src_java_org_apache_commons_lang_text_StrBuilder,1486,139,1519,33,0,0,142,3,0,0,1516,30,0,3,142,3,0,0
Lang/61,src_java_org_apache_commons_lang_text_StrBuilder,1483,140,1520,37,0,0,142,2,0,0,1516,33,0,4,142,2,0,0
Lang/63,src_java_org_apache_commons_lang_time_DurationFormatUtils,326,30,408,82,0,1,32,2,0,0,402,76,0,7,32,2,0,0
Lang/64,src_java_org_apache_commons_lang_enums_ValuedEnum,40,6,51,11,0,0,8,2,0,0,50,10,0,1,8,2,0,0
Lang/65,src_java_org_apache_commons_lang_time_DateUtils,389,49,454,65,0,0,51,2,0,0,451,62,0,3,51,2,0,0
Lang/7,src_main_java_org_apache_commons_lang3_math_NumberUtils,696,63,840,144,0,3,66,3,0,0,835,139,0,8,66,3,0,0
Lang/8,src_main_java_org_apache_commons_lang3_time_FastDatePrinter,823,122,856,33,0,0,126,4,0,0,847,24,0,9,126,4,0,0
Lang/9,src_main_java_org_apache_commons_lang3_time_FastDateParser,575,95,614,39,0,0,97,2,0,0,614,39,0,0,97,2,0,0
Math/1,src_main_java_org_apache_commons_math3_fraction_BigFraction,456,71,518,62,0,0,73,2,0,0,513,57,0,5,73,2,0,0
Math/1,src_main_java_org_apache_commons_math3_fraction_Fraction,284,48,346,62,0,0,50,2,0,0,341,57,0,5,50,2,0,0
Math/10,src_main_java_org_apache_commons_math3_analysis_differentiation_DSCompiler,1016,54,1051,35,0,0,56,2,0,0,1045,29,0,6,56,2,0,0
Math/100,src_java_org_apache_commons_math_estimation_AbstractEstimator,101,21,153,52,0,0,24,3,0,0,147,46,0,6,24,3,0,0
Math/101,src_java_org_apache_commons_math_complex_ComplexFormat,265,32,316,51,0,0,34,2,0,0,313,48,0,3,34,2,0,0
Math/102,src_java_org_apache_commons_math_stat_inference_ChiSquareTestImpl,229,18,253,24,0,0,20,2,0,0,249,20,1,4,20,2,0,0
Math/103,src_java_org_apache_commons_math_distribution_NormalDistributionImpl,89,13,102,13,0,0,15,2,0,0,100,11,0,2,15,2,0,0
Math/104,src_java_org_apache_commons_math_special_Gamma,116,12,121,5,0,0,14,2,0,0,121,5,0,0,14,2,0,0
Math/105,src_java_org_apache_commons_math_stat_regression_SimpleRegression,157,30,167,10,0,0,32,2,0,0,165,8,0,2,32,2,0,0
Math/106,src_java_org_apache_commons_math_fraction_ProperFractionFormat,53,8,101,48,0,0,10,2,0,0,98,45,0,3,10,2,0,0
Math/11,src_main_java_org_apache_commons_math3_distribution_MultivariateNormalDistribution,102,12,119,17,0,0,14,2,0,0,117,15,0,2,14,2,0,0
Math/12,src_main_java_org_apache_commons_math3_random_BitsStreamGenerator,114,15,119,5,0,0,16,1,0,0,119,5,0,0,16,1,0,0
Math/13,src_main_java_org_apache_commons_math3_optimization_general_AbstractLeastSquaresOptimizer,194,32,206,12,0,0,34,2,0,0,203,9,0,3,34,2,0,0
Math/14,src_main_java_org_apache_commons_math3_optim_nonlinear_vector_Weight,13,3,22,9,0,1,5,2,0,0,21,8,0,2,5,2,0,0
Math/14,src_main_java_org_apache_commons_math3_optim_nonlinear_vector_jacobian_AbstractLeastSquaresOptimizer,96,14,108,12,0,0,16,2,0,0,106,10,0,2,16,2,0,0
Math/15,src_main_java_org_apache_commons_math3_util_FastMath,2202,130,2333,131,0,0,132,2,0,0,2331,129,0,2,132,2,0,0
Math/16,src_main_java_org_apache_commons_math3_util_FastMath,2189,128,2311,122,0,0,131,3,0,0,2307,118,2,4,131,3,0,0
Math/17,src_main_java_org_apache_commons_math3_dfp_Dfp,1665,95,1674,9,0,0,97,2,0,0,1672,7,0,2,97,2,0,0
Math/18,src_main_java_org_apache_commons_math3_optimization_direct_CMAESOptimizer,839,108,889,50,0,5,113,5,0,0,881,42,0,13,113,5,0,0
Math/19,src_main_java_org_apache_commons_math3_optimization_direct_CMAESOptimizer,831,111,881,50,0,0,113,2,0,0,881,50,0,0,113,2,0,0
Math/2,src_main_java_org_apache_commons_math3_distribution_HypergeometricDistribution,172,23,184,12,0,0,25,2,0,0,180,8,0,4,25,2,0,0
Math/20,src_main_java_org_apache_commons_math3_optimization_direct_CMAESOptimizer,869,110,882,13,0,0,113,3,0,0,880,11,0,2,113,3,0,0
Math/21,src_main_java_org_apache_commons_math3_linear_RectangularCholeskyDecomposition,10,4,82,72,0,2,6,2,0,0,79,69,1,5,6,2,0,0
Math/22,src_main_java_org_apache_commons_math3_distribution_FDistribution,124,22,134,10,0,0,24,2,0,0,132,8,0,2,24,2,0,0
Math/22,src_main_java_org_apache_commons_math3_distribution_UniformRealDistribution,99,19,109,10,0,0,21,2,0,0,107,8,0,2,21,2,0,0
Math/23,src_main_java_org_apache_commons_math3_optimization_univariate_BrentOptimizer,39,7,180,141,0,0,9,2,0,0,177,138,0,3,9,2,0,0
Math/24,src_main_java_org_apache_commons_math3_optimization_univariate_BrentOptimizer,39,7,176,137,0,4,9,2,0,0,172,133,0,8,9,2,0,0
Math/25,src_main_java_org_apache_commons_math3_optimization_fitting_HarmonicFitter,74,11,139,65,0,0,14,3,0,0,138,64,0,1,14,3,0,0
Math/26,src_main_java_org_apache_commons_math3_fraction_Fraction,284,47,349,65,0,0,49,2,0,0,341,57,0,8,49,2,0,0
Math/27,src_main_java_org_apache_commons_math3_fraction_Fraction,337,47,345,8,0,3,49,2,0,0,345,8,0,3,49,2,0,0
Math/28,src_main_java_org_apache_commons_math3_optimization_linear_SimplexSolver,79,10,136,57,0,0,12,2,0,0,126,47,7,10,12,2,0,0
Math/29,src_main_java_org_apache_commons_math3_linear_OpenMapRealVector,625,66,656,31,0,0,69,3,0,0,650,25,0,6,69,3,0,0
Math/3,src_main_java_org_apache_commons_math3_util_MathArrays,816,47,867,51,0,0,49,2,0,0,864,48,0,3,49,2,0,0
Math/30,src_main_java_org_apache_commons_math3_stat_inference_MannWhitneyUTest,66,7,85,19,0,0,9,2,0,0,80,14,0,5,9,2,0,0
Math/31,src_main_java_org_apache_commons_math3_util_ContinuedFraction,36,7,76,40,13,12,9,2,0,0,73,37,0,15,9,2,0,0
Math/32,src_main_java_org_apache_commons_math3_geometry_euclidean_twod_PolygonsSet,244,24,293,49,0,0,26,2,0,0,292,48,0,1,26,2,0,0
Math/33,src_main_java_org_apache_commons_math3_optimization_linear_SimplexTableau,328,44,367,39,0,0,46,2,0,0,367,39,0,0,46,2,0,0
Math/34,src_main_java_org_apache_commons_math3_genetics_ListPopulation,102,14,112,10,0,0,16,2,0,0,111,9,0,1,16,2,0,0
Math/35,src_main_java_org_apache_commons_math3_genetics_ElitisticListPopulation,26,4,47,21,0,0,7,3,0,0,42,16,0,5,7,3,0,0
Math/36,src_main_java_org_apache_commons_math_fraction_BigFraction,489,70,507,18,0,0,73,3,0,0,505,16,0,2,73,3,0,0
Math/37,src_main_java_org_apache_commons_math_complex_Complex,428,52,455,27,0,0,55,3,0,0,453,25,0,2,55,3,0,0
Math/38,src_main_java_org_apache_commons_math_optimization_direct_BOBYQAOptimizer,1495,54,1642,147,0,0,56,2,0,0,1636,141,0,6,56,2,0,0
Math/39,src_main_java_org_apache_commons_math_ode_nonstiff_EmbeddedRungeKuttaIntegrator,91,19,192,101,0,0,21,2,0,0,187,96,0,5,21,2,0,0
Math/4,src_main_java_org_apache_commons_math3_geometry_euclidean_threed_SubLine,42,7,59,17,0,0,9,2,0,0,56,14,0,3,9,2,0,0
Math/4,src_main_java_org_apache_commons_math3_geometry_euclidean_twod_SubLine,84,8,103,19,0,0,10,2,0,0,100,16,0,3,10,2,0,0
Math/40,src_main_java_org_apache_commons_math_analysis_solvers_BracketingNthOrderBrentSolver,91,14,222,131,0,6,16,2,0,0,219,128,0,9,16,2,0,0
Math/41,src_main_java_org_apache_commons_math_stat_descriptive_moment_Variance,206,24,247,41,0,0,26,2,0,0,241,35,0,6,26,2,0,0
Math/42,src_main_java_org_apache_commons_math_optimization_linear_SimplexTableau,336,44,363,27,0,0,46,2,0,0,362,26,0,1,46,2,0,0
Math/43,src_main_java_org_apache_commons_math_stat_descriptive_SummaryStatistics,331,57,360,29,0,0,59,2,0,0,353,22,0,7,59,2,0,0
Math/44,src_main_java_org_apache_commons_math_ode_AbstractIntegrator,174,33,245,71,0,0,35,2,0,0,240,66,0,5,35,2,0,0
Math/45,src_main_java_org_apache_commons_math_linear_OpenMapRealMatrix,190,19,205,15,0,0,21,2,0,0,203,13,0,2,21,2,0,0
Math/46,src_main_java_org_apache_commons_math_complex_Complex,375,51,422,47,0,0,54,3,0,0,411,36,0,11,54,3,0,0
Math/47,src_main_java_org_apache_commons_math_complex_Complex,365,49,421,56,0,0,53,4,0,0,407,42,0,14,53,4,0,0
Math/48,src_main_java_org_apache_commons_math_analysis_solvers_BaseSecantSolver,60,10,153,93,0,0,12,2,0,0,147,87,6,6,12,2,0,0
Math/49,src_main_java_org_apache_commons_math_linear_OpenMapRealVector,713,75,773,60,0,0,80,5,0,0,759,46,0,14,80,5,0,0
Math/5,src_main_java_org_apache_commons_math3_complex_Complex,441,53,467,26,0,0,55,2,0,0,466,25,0,1,55,2,0,0
Math/50,src_main_java_org_apache_commons_math_analysis_solvers_BaseSecantSolver,60,10,153,93,0,0,12,2,0,0,147,87,6,6,12,2,0,0
Math/51,src_main_java_org_apache_commons_math_analysis_solvers_BaseSecantSolver,60,10,150,90,0,0,12,2,0,0,150,90,0,0,12,2,0,0
Math/52,src_main_java_org_apache_commons_math_geometry_euclidean_threed_Rotation,410,26,475,65,0,0,28,2,0,0,467,57,0,8,28,2,0,0
Math/53,src_main_java_org_apache_commons_math_complex_Complex,342,44,353,11,0,0,46,2,0,0,350,8,0,3,46,2,0,0
Math/54,src_main_java_org_apache_commons_math_dfp_Dfp,1488,86,1600,112,1,2,89,3,0,0,1597,109,0,5,89,3,0,0
Math/55,src_main_java_org_apache_commons_math_geometry_Vector3D,286,49,316,30,0,0,51,2,0,0,301,15,0,15,51,2,0,0
Math/56,src_main_java_org_apache_commons_math_util_MultidimensionalCounter,120,22,145,25,0,1,24,2,0,0,143,23,0,3,24,2,0,0
Math/57,src_main_java_org_apache_commons_math_stat_clustering_KMeansPlusPlusClusterer,155,11,192,37,0,0,13,2,0,0,187,32,0,5,13,2,0,0
Math/58,src_main_java_org_apache_commons_math_optimization_fitting_GaussianFitter,185,17,195,10,0,0,19,2,0,0,194,9,0,1,19,2,0,0
Math/59,src_main_java_org_apache_commons_math_util_FastMath,2205,90,2245,40,0,0,92,2,0,0,2213,8,0,32,92,2,0,0
Math/6,src_main_java_org_apache_commons_math3_optim_BaseOptimizer,89,17,100,11,0,0,19,2,0,0,99,10,0,1,19,2,0,0
Math/6,src_main_java_org_apache_commons_math3_optim_nonlinear_scalar_gradient_NonLinearConjugateGradientOptimizer,124,23,202,78,0,0,25,2,0,0,200,76,0,2,25,2,0,0
Math/6,src_main_java_org_apache_commons_math3_optim_nonlinear_scalar_noderiv_CMAESOptimizer,727,107,850,123,0,0,109,2,0,0,848,121,0,2,109,2,0,0
Math/6,src_main_java_org_apache_commons_math3_optim_nonlinear_scalar_noderiv_PowellOptimizer,95,17,176,81,0,0,19,2,0,0,174,79,0,2,19,2,0,0
Math/6,src_main_java_org_apache_commons_math3_optim_nonlinear_scalar_noderiv_SimplexOptimizer,56,8,88,32,0,0,10,2,0,0,86,30,0,2,10,2,0,0
Math/6,src_main_java_org_apache_commons_math3_optim_nonlinear_vector_jacobian_GaussNewtonOptimizer,19,4,86,67,0,0,6,2,0,0,84,65,0,2,6,2,0,0
Math/6,src_main_java_org_apache_commons_math3_optim_nonlinear_vector_jacobian_LevenbergMarquardtOptimizer,332,25,523,191,0,0,27,2,0,0,521,189,0,2,27,2,0,0
Math/60,src_main_java_org_apache_commons_math_distribution_NormalDistributionImpl,110,18,124,14,0,0,20,2,0,0,122,12,0,2,20,2,0,0
Math/61,src_main_java_org_apache_commons_math_distribution_PoissonDistributionImpl,79,17,97,18,0,3,19,2,0,0,93,14,0,7,19,2,0,0
Math/62,src_main_java_org_apache_commons_math_optimization_univariate_MultiStartUnivariateRealOptimizer,66,15,108,42,1,6,18,3,0,0,94,28,0,20,18,3,0,0
Math/63,src_main_java_org_apache_commons_math_util_MathUtils,1143,81,1154,11,0,1,83,2,0,0,1151,8,0,4,83,2,0,0
Math/64,src_main_java_org_apache_commons_math_optimization_general_LevenbergMarquardtOptimizer,313,23,487,174,0,0,25,2,0,0,478,165,2,9,25,2,0,0
Math/65,src_main_java_org_apache_commons_math_optimization_general_AbstractLeastSquaresOptimizer,175,35,197,22,0,0,38,3,0,0,194,19,0,3,38,3,0,0
Math/66,src_main_java_org_apache_commons_math_optimization_univariate_BrentOptimizer,0,1,149,149,3,4,5,4,0,0,135,135,0,18,5,4,0,0
Math/67,src_main_java_org_apache_commons_math_optimization_MultiStartUnivariateRealOptimizer,184,28,198,14,0,0,31,3,0,0,196,12,0,2,31,3,0,0
Math/68,src_main_java_org_apache_commons_math_optimization_general_LevenbergMarquardtOptimizer,297,20,468,171,1,1,23,3,0,0,457,160,4,12,23,3,0,0
Math/69,src_main_java_org_apache_commons_math_stat_correlation_PearsonsCorrelation,118,14,140,22,0,5,16,2,0,0,138,20,0,7,16,2,0,0
Math/7,src_main_java_org_apache_commons_math3_ode_AbstractIntegrator,190,33,261,71,0,15,35,2,0,0,254,64,0,22,35,2,0,0
Math/70,src_main_java_org_apache_commons_math_analysis_solvers_BisectionSolver,63,5,78,15,0,0,7,2,0,0,72,9,0,6,7,2,0,0
Math/71,src_main_java_org_apache_commons_math_ode_nonstiff_EmbeddedRungeKuttaIntegrator,91,19,219,128,0,0,21,2,0,0,211,120,0,8,21,2,0,0
Math/71,src_main_java_org_apache_commons_math_ode_nonstiff_RungeKuttaIntegrator,15,6,111,96,0,0,8,2,0,0,104,89,0,7,8,2,0,0
Math/72,src_main_java_org_apache_commons_math_analysis_solvers_BrentSolver,153,8,196,43,0,0,10,2,0,0,186,33,0,10,10,2,0,0
Math/73,src_main_java_org_apache_commons_math_analysis_solvers_BrentSolver,153,8,191,38,0,0,10,2,0,0,185,32,0,6,10,2,0,0
Math/74,src_main_java_org_apache_commons_math_ode_nonstiff_EmbeddedRungeKuttaIntegrator,91,19,215,124,0,0,21,2,0,0,204,113,0,11,21,2,0,0
Math/75,src_main_java_org_apache_commons_math_stat_Frequency,317,38,329,12,0,0,40,2,0,0,327,10,0,2,40,2,0,0
Math/76,src_main_java_org_apache_commons_math_linear_SingularValueDecompositionImpl,182,35,258,76,0,4,38,3,0,0,246,64,2,16,38,3,0,0
Math/77,src_main_java_org_apache_commons_math_linear_ArrayRealVector,979,106,995,16,0,0,108,2,0,0,990,11,0,5,108,2,0,0
Math/77,src_main_java_org_apache_commons_math_linear_OpenMapRealVector,771,79,777,6,0,0,80,1,0,0,777,6,0,0,80,1,0,0
Math/78,src_main_java_org_apache_commons_math_ode_events_EventState,106,24,166,60,0,0,26,2,0,0,162,56,0,4,26,2,0,0
Math/79,src_main_java_org_apache_commons_math_util_MathUtils,957,72,976,19,0,0,74,2,0,0,973,16,0,3,74,2,0,0
Math/8,src_main_java_org_apache_commons_math3_distribution_DiscreteDistribution,67,9,84,17,0,3,11,2,0,0,80,13,0,7,11,2,0,0
Math/80,src_main_java_org_apache_commons_math_linear_EigenDecompositionImpl,1225,76,1251,26,0,0,78,2,0,0,1249,24,0,2,78,2,0,0
Math/81,src_main_java_org_apache_commons_math_linear_EigenDecompositionImpl,920,74,1250,330,0,0,78,4,0,0,1245,325,0,5,78,4,0,0
Math/82,src_main_java_org_apache_commons_math_optimization_linear_SimplexSolver,99,10,124,25,0,0,12,2,0,0,121,22,0,3,12,2,0,0
Math/83,src_main_java_org_apache_commons_math_optimization_linear_SimplexTableau,299,41,340,41,0,0,44,3,0,0,332,33,0,8,44,3,0,0
Math/84,src_main_java_org_apache_commons_math_optimization_direct_MultiDirectional,35,5,66,31,0,0,7,2,0,0,61,26,0,5,7,2,0,0
Math/85,src_java_org_apache_commons_math_analysis_solvers_UnivariateRealSolverUtils,64,8,105,41,0,0,10,2,0,0,97,33,0,8,10,2,0,0
Math/86,src_java_org_apache_commons_math_linear_CholeskyDecompositionImpl,171,19,219,48,0,0,21,2,0,0,212,41,0,7,21,2,0,0
Math/87,src_java_org_apache_commons_math_optimization_linear_SimplexTableau,299,39,318,19,0,0,41,2,0,0,312,13,2,6,41,2,0,0
Math/88,src_java_org_apache_commons_math_optimization_linear_SimplexTableau,297,39,314,17,0,0,41,2,0,0,312,15,1,2,41,2,0,0
Math/89,src_java_org_apache_commons_math_stat_Frequency,255,32,266,11,0,0,34,2,0,0,264,9,0,2,34,2,0,0
Math/9,src_main_java_org_apache_commons_math3_geometry_euclidean_threed_Line,120,18,128,8,0,1,20,2,0,0,127,7,0,2,20,2,0,0
Math/90,src_java_org_apache_commons_math_stat_Frequency,236,31,260,24,0,0,33,2,0,0,258,22,0,2,33,2,0,0
Math/91,src_java_org_apache_commons_math_fraction_Fraction,282,29,292,10,0,4,31,2,0,0,291,9,0,5,31,2,0,0
Math/92,src_java_org_apache_commons_math_util_MathUtils,557,50,617,60,0,0,54,4,0,0,609,52,0,8,54,4,0,0
Math/93,src_java_org_apache_commons_math_util_MathUtils,573,50,613,40,0,0,54,4,0,0,606,33,0,7,54,4,0,0
Math/94,src_java_org_apache_commons_math_util_MathUtils,570,51,615,45,0,0,53,2,0,0,608,38,0,7,53,2,0,0
Math/95,src_java_org_apache_commons_math_distribution_FDistributionImpl,76,12,91,15,0,0,14,2,0,0,89,13,0,2,14,2,0,0
Math/96,src_java_org_apache_commons_math_complex_Complex,265,36,296,31,1,0,38,2,0,0,290,25,0,6,38,2,0,0
Math/97,src_java_org_apache_commons_math_analysis_BrentSolver,123,4,148,25,0,0,6,2,0,0,144,21,0,4,6,2,0,0
Math/98,src_java_org_apache_commons_math_linear_BigMatrixImpl,911,70,936,25,0,0,72,2,0,0,933,22,0,3,72,2,0,0
Math/98,src_java_org_apache_commons_math_linear_RealMatrixImpl,744,52,770,26,0,0,54,2,0,0,767,23,0,3,54,2,0,0
Math/99,src_java_org_apache_commons_math_util_MathUtils,625,52,681,56,0,0,55,3,0,0,676,51,0,5,55,3,0,0
Mockito/1,src_org_mockito_internal_invocation_InvocationMatcher,120,17,142,22,0,0,19,2,0,0,136,16,4,6,19,2,0,0
Mockito/10,src_org_mockito_internal_stubbing_defaultanswers_ReturnsDeepStubs,89,19,122,33,0,0,23,4,0,0,114,25,1,8,23,4,0,0
Mockito/11,src_org_mockito_internal_creation_DelegatingMethod,41,9,58,17,0,0,12,3,0,0,54,13,0,4,12,3,0,0
Mockito/12,src_org_mockito_internal_util_reflection_GenericMaster,0,0,15,15,0,0,2,2,0,0,12,12,0,3,2,2,0,0
Mockito/13,src_org_mockito_internal_MockHandler,39,12,76,37,0,0,14,2,0,0,73,34,0,3,14,2,0,0
Mockito/14,src_org_mockito_internal_MockHandler,39,12,73,34,0,0,14,2,0,0,70,31,0,3,14,2,0,0
Mockito/14,src_org_mockito_internal_MockitoCore,131,16,151,20,0,0,18,2,0,0,146,15,0,5,18,2,0,0
Mockito/15,src_org_mockito_internal_configuration_injection_FinalMockCandidateFilter,5,1,31,26,0,0,4,3,0,0,23,18,0,8,3,2,0,1
Mockito/16,src_org_mockito_Mockito,197,32,219,22,0,0,35,3,0,0,211,14,0,8,35,3,0,0
Mockito/16,src_org_mockito_internal_MockitoCore,125,15,140,15,0,0,17,2,0,0,134,9,0,6,17,2,0,0
Mockito/17,src_org_mockito_internal_creation_MockSettingsImpl,66,15,78,12,0,3,18,3,0,0,77,11,0,4,18,3,0,0
Mockito/17,src_org_mockito_internal_util_MockUtil,64,9,90,26,0,0,11,2,0,0,85,21,0,5,11,2,0,0
Mockito/18,src_org_mockito_internal_stubbing_defaultanswers_ReturnsEmptyValues,19,4,72,53,0,0,6,2,0,0,50,31,20,22,6,2,0,0
Mockito/19,src_org_mockito_internal_configuration_injection_PropertyAndSetterInjection,59,7,81,22,0,0,9,2,0,0,77,18,0,4,9,2,0,0
Mockito/19,src_org_mockito_internal_configuration_injection_filter_FinalMockCandidateFilter,17,2,33,16,0,0,4,2,0,0,29,12,0,4,4,2,0,0
Mockito/19,src_org_mockito_internal_configuration_injection_filter_MockCandidateFilter,0,0,8,8,0,1,2,2,0,0,3,3,0,6,1,1,0,1
Mockito/19,src_org_mockito_internal_configuration_injection_filter_NameBasedCandidateFilter,5,3,26,21,0,0,5,2,0,0,22,17,0,4,5,2,0,0
Mockito/19,src_org_mockito_internal_configuration_injection_filter_TypeBasedCandidateFilter,5,2,23,18,0,0,4,2,0,0,19,14,0,4,4,2,0,0
Mockito/2,src_org_mockito_internal_util_Timer,11,4,19,8,0,0,6,2,0,0,18,7,0,1,6,2,0,0
Mockito/20,src_org_mockito_internal_creation_bytebuddy_ByteBuddyMockMaker,67,10,96,29,0,0,12,2,0,0,92,25,0,4,12,2,0,0
Mockito/21,src_org_mockito_internal_creation_instance_ConstructorInstantiator,26,4,51,25,0,8,7,3,0,0,36,10,0,23,6,2,0,1
Mockito/22,src_org_mockito_internal_matchers_Equality,31,4,49,18,0,0,6,2,0,0,47,16,0,2,6,2,0,0
Mockito/23,src_org_mockito_internal_stubbing_defaultanswers_ReturnsDeepStubs,48,7,82,34,0,1,13,6,0,0,71,23,0,12,13,6,0,0
Mockito/24,src_org_mockito_internal_stubbing_defaultanswers_ReturnsEmptyValues,50,4,73,23,0,0,6,2,0,0,68,18,0,5,6,2,0,0
Mockito/25,src_org_mockito_internal_stubbing_defaultanswers_ReturnsDeepStubs,14,4,53,39,0,0,8,4,0,0,37,23,0,16,7,3,0,1
Mockito/26,src_org_mockito_internal_util_Primitives,34,8,66,32,0,0,9,1,0,0,37,3,0,29,9,1,0,0
Mockito/27,src_org_mockito_internal_util_MockUtil,91,10,104,13,0,0,12,2,0,0,100,9,0,4,12,2,0,0
Mockito/28,src_org_mockito_internal_configuration_DefaultInjectionEngine,44,5,57,13,0,0,7,2,0,0,54,10,0,3,7,2,0,0
Mockito/29,src_org_mockito_internal_matchers_Same,22,5,36,14,0,0,7,2,0,0,35,13,0,1,7,2,0,0
Mockito/3,src_org_mockito_internal_invocation_InvocationMatcher,103,15,138,35,1,1,17,2,0,0,129,26,7,10,17,2,0,0
Mockito/30,src_org_mockito_exceptions_Reporter,331,49,340,9,0,0,51,2,0,0,339,8,0,1,51,2,0,0
Mockito/30,src_org_mockito_internal_stubbing_defaultanswers_ReturnsSmartNulls,26,7,48,22,0,0,10,3,0,0,41,15,0,7,10,3,0,0
Mockito/31,src_org_mockito_internal_stubbing_defaultanswers_ReturnsSmartNulls,34,7,48,14,0,0,10,3,0,0,44,10,0,4,10,3,0,0
Mockito/32,src_org_mockito_internal_configuration_SpyAnnotationEngine,18,2,56,38,0,0,4,2,0,0,52,34,0,4,4,2,0,0
Mockito/33,src_org_mockito_internal_invocation_InvocationMatcher,102,16,118,16,0,0,18,2,0,0,115,13,0,3,18,2,0,0
Mockito/34,src_org_mockito_internal_invocation_InvocationMatcher,85,15,106,21,0,0,17,2,0,0,104,19,0,2,17,2,0,0
Mockito/35,src_org_mockito_Matchers,313,47,346,33,0,0,51,4,0,0,336,23,0,10,51,4,0,0
Mockito/36,src_org_mockito_internal_invocation_Invocation,205,39,218,13,0,0,41,2,0,0,215,10,0,3,41,2,0,0
Mockito/37,src_org_mockito_internal_stubbing_answers_AnswersValidator,40,4,58,18,0,0,6,2,0,0,56,16,0,2,6,2,0,0
Mockito/38,src_org_mockito_internal_verification_argumentmatching_ArgumentMatchingTool,29,2,41,12,0,0,4,2,0,0,38,9,0,3,4,2,0,0
Mockito/4,src_org_mockito_exceptions_Reporter,481,71,507,26,0,0,75,4,0,0,502,21,0,5,75,4,0,0
Mockito/5,src_org_mockito_internal_verification_VerificationOverTimeImpl,62,13,90,28,0,0,15,2,0,0,89,27,0,1,15,2,0,0
Mockito/6,src_org_mockito_Matchers,237,34,375,138,0,0,55,21,0,0,343,106,0,32,55,21,0,0
Mockito/7,src_org_mockito_internal_util_reflection_GenericMetadataSupport,434,67,451,17,0,0,70,3,0,0,450,16,0,1,70,3,0,0
Mockito/8,src_org_mockito_internal_util_reflection_GenericMetadataSupport,426,68,450,24,0,0,70,2,0,0,449,23,0,1,70,2,0,0
Mockito/9,src_org_mockito_internal_stubbing_answers_CallsRealMethods,0,1,10,10,0,0,3,2,0,0,7,7,0,3,3,2,0,0
Time/1,src_main_java_org_joda_time_Partial,455,53,525,70,0,0,55,2,0,0,521,66,0,4,55,2,0,0
Time/1,src_main_java_org_joda_time_field_UnsupportedDurationField,166,27,178,12,0,0,29,2,0,0,176,10,0,2,29,2,0,0
Time/10,src_main_java_org_joda_time_base_BaseSingleFieldPeriod,150,19,180,30,0,0,21,2,0,0,177,27,0,3,21,2,0,0
Time/11,src_main_java_org_joda_time_tz_ZoneInfoCompiler,654,64,657,3,0,0,66,2,0,0,657,3,0,0,66,2,0,0
Time/12,src_main_java_org_joda_time_LocalDate,876,125,914,38,0,0,128,3,0,0,898,22,2,16,128,3,0,0
Time/12,src_main_java_org_joda_time_LocalDateTime,1006,145,1036,30,0,0,148,3,0,0,1028,22,2,8,148,3,0,0
Time/13,src_main_java_org_joda_time_format_PeriodFormatterBuilder,1382,158,1452,70,0,0,162,4,0,0,1446,64,0,6,162,4,0,0
Time/14,src_main_java_org_joda_time_chrono_BasicMonthOfYearDateTimeField,200,22,224,24,0,0,24,2,0,0,219,19,0,5,24,2,0,0
Time/15,src_main_java_org_joda_time_field_FieldUtils,183,15,205,22,0,0,17,2,0,0,203,20,0,2,17,2,0,0
Time/16,src_main_java_org_joda_time_format_DateTimeFormatter,439,52,473,34,0,0,54,2,0,0,470,31,0,3,54,2,0,0
Time/17,src_main_java_org_joda_time_DateTimeZone,704,67,729,25,0,0,69,2,0,0,720,16,0,9,69,2,0,0
Time/18,src_main_java_org_joda_time_chrono_GJChronology,813,94,843,30,0,0,96,2,0,0,834,21,0,9,96,2,0,0
Time/19,src_main_java_org_joda_time_DateTimeZone,689,67,726,37,0,0,69,2,0,0,722,33,0,4,69,2,0,0
Time/2,src_main_java_org_joda_time_Partial,402,52,522,120,0,0,55,3,0,0,515,113,0,7,55,3,0,0
Time/2,src_main_java_org_joda_time_field_UnsupportedDurationField,166,27,178,12,0,0,29,2,0,0,176,10,0,2,29,2,0,0
Time/20,src_main_java_org_joda_time_format_DateTimeFormatterBuilder,2427,224,2453,26,0,0,227,3,0,0,2441,14,3,12,227,3,0,0
Time/22,src_main_java_org_joda_time_base_BasePeriod,367,34,378,11,0,0,36,2,0,0,377,10,0,1,36,2,0,0
Time/23,src_main_java_org_joda_time_DateTimeZone,671,67,724,53,9,8,69,2,0,0,716,45,15,16,69,2,0,0
Time/24,src_main_java_org_joda_time_format_DateTimeParserBucket,251,48,301,50,0,0,50,2,0,0,299,48,0,2,50,2,0,0
Time/25,src_main_java_org_joda_time_DateTimeZone,675,66,701,26,0,0,68,2,0,0,697,22,0,4,68,2,0,0
Time/27,src_main_java_org_joda_time_format_PeriodFormatterBuilder,1419,160,1449,30,0,0,162,2,0,0,1445,26,0,4,162,2,0,0
Time/3,src_main_java_org_joda_time_MutableDateTime,663,106,734,71,0,0,117,11,0,0,723,60,0,11,117,11,0,0
Time/4,src_main_java_org_joda_time_Partial,464,53,521,57,0,0,55,2,0,0,516,52,0,5,55,2,0,0
Time/5,src_main_java_org_joda_time_Period,707,87,738,31,0,2,89,2,0,0,733,26,2,7,89,2,0,0
Time/6,src_main_java_org_joda_time_chrono_GJChronology,769,91,862,93,0,0,96,5,0,0,851,82,0,11,96,5,0,0
Time/7,src_main_java_org_joda_time_format_DateTimeFormatter,439,52,476,37,0,0,54,2,0,0,470,31,0,6,54,2,0,0
Time/8,src_main_java_org_joda_time_DateTimeZone,706,68,746,40,0,0,70,2,0,0,738,32,0,8,70,2,0,0
Time/9,src_main_java_org_joda_time_DateTimeZone,695,66,744,49,0,0,69,3,0,0,724,29,0,20,69,3,0,0
