Chart/1,source_org_jfree_chart_renderer_category_AbstractCategoryItemRenderer,646,80,677,31,0,0,82,2,0,0,677,31,0,0,82,2,0,0
Chart/10,source_org_jfree_chart_imagemap_StandardToolTipTagFragmentGenerator,2,1,4,2,0,0,3,2,0,0,4,2,0,0,3,2,0,0
Chart/11,source_org_jfree_chart_util_ShapeUtilities,216,21,248,32,0,0,23,2,0,0,247,31,0,1,23,2,0,0
Chart/12,source_org_jfree_chart_plot_MultiplePiePlot,226,28,240,14,0,0,30,2,0,0,240,14,0,0,30,2,0,0
Chart/13,source_org_jfree_chart_block_BorderArrangement,240,15,289,49,0,0,17,2,0,0,289,49,0,0,17,2,0,0
Chart/14,source_org_jfree_chart_plot_CategoryPlot,1484,217,1511,27,0,0,220,3,0,0,1511,27,0,0,220,3,0,0
Chart/14,source_org_jfree_chart_plot_XYPlot,1920,252,1947,27,0,0,255,3,0,0,1947,27,0,0,255,3,0,0
Chart/15,source_org_jfree_chart_plot_PiePlot,990,170,1007,17,0,0,173,3,0,0,1007,17,0,0,173,3,0,0
Chart/16,source_org_jfree_data_category_DefaultIntervalCategoryDataset,214,34,268,54,0,0,37,3,0,0,264,50,0,4,37,3,0,0
Chart/17,source_org_jfree_data_time_TimeSeries,364,52,367,3,0,0,54,2,0,0,366,2,0,1,54,2,0,0
Chart/18,source_org_jfree_data_DefaultKeyedValues,143,24,152,9,0,0,27,3,0,0,151,8,0,1,27,3,0,0
Chart/18,source_org_jfree_data_DefaultKeyedValues2D,184,27,191,7,0,0,29,2,0,0,191,7,0,0,29,2,0,0
Chart/19,source_org_jfree_chart_plot_CategoryPlot,1429,203,1441,12,0,0,206,3,0,0,1441,12,0,0,206,3,0,0
Chart/2,source_org_jfree_data_general_DatasetUtilities,1014,50,1108,94,0,0,53,3,0,0,1106,92,2,2,53,3,0,0
Chart/20,source_org_jfree_chart_plot_ValueMarker,25,6,28,3,0,0,8,2,0,0,27,2,0,1,8,2,0,0
Chart/21,source_org_jfree_data_statistics_DefaultBoxAndWhiskerCategoryDataset,179,44,219,40,0,0,47,3,0,0,218,39,1,1,47,3,0,0
Chart/22,source_org_jfree_data_KeyedObjects2D,117,21,167,50,0,0,26,5,0,0,166,49,0,1,26,5,0,0
Chart/23,source_org_jfree_chart_renderer_category_MinMaxCategoryRenderer,166,34,166,0,0,0,35,1,0,0,166,0,0,0,35,1,0,0
Chart/24,source_org_jfree_chart_renderer_GrayPaintScale,29,8,34,5,0,0,10,2,0,0,33,4,0,1,10,2,0,0
Chart/25,source_org_jfree_chart_renderer_category_StatisticalBarRenderer,49,12,219,170,0,0,15,3,0,0,213,164,6,6,15,3,0,0
Chart/26,source_org_jfree_chart_axis_Axis,332,98,402,70,0,0,100,2,0,0,401,69,1,1,100,2,0,0
Chart/3,source_org_jfree_data_time_TimeSeries,472,64,493,21,0,0,66,2,0,0,493,21,0,0,66,2,0,0
Chart/4,source_org_jfree_chart_plot_XYPlot,2211,290,2284,73,0,0,292,2,0,0,2282,71,2,2,292,2,0,0
Chart/5,source_org_jfree_data_xy_XYSeries,206,38,232,26,0,0,40,2,0,0,231,25,1,1,40,2,0,0
Chart/6,source_org_jfree_chart_util_ShapeList,32,7,40,8,0,0,9,2,0,0,39,7,0,1,9,2,0,0
Chart/7,source_org_jfree_data_time_TimePeriodValues,130,38,186,56,0,0,40,2,0,0,186,56,0,0,40,2,0,0
Chart/8,source_org_jfree_data_time_Week,215,31,217,2,0,0,33,2,0,0,217,2,0,0,33,2,0,0
Chart/9,source_org_jfree_data_time_TimeSeries,335,52,368,33,0,0,54,2,0,0,367,32,0,1,54,2,0,0
Cli/1,src_java_org_apache_commons_cli_CommandLine,25,12,47,22,0,2,20,8,0,0,42,17,0,7,20,8,0,0
Cli/10,src_java_org_apache_commons_cli_Parser,132,14,135,3,0,0,16,2,0,0,134,2,0,1,16,2,0,0
Cli/11,src_java_org_apache_commons_cli_HelpFormatter,227,55,242,15,0,0,57,2,0,0,242,15,0,0,57,2,0,0
Cli/12,src_java_org_apache_commons_cli_GnuParser,0,0,35,35,0,0,2,2,0,0,35,35,0,0,2,2,0,0
Cli/13,src_java_org_apache_commons_cli2_WriteableCommandLine,0,7,0,0,0,0,8,1,0,0,0,0,0,0,8,1,0,0
Cli/13,src_java_org_apache_commons_cli2_commandline_WriteableCommandLineImpl,98,27,98,0,0,0,28,1,0,0,98,0,0,0,28,1,0,0
Cli/13,src_java_org_apache_commons_cli2_option_ArgumentImpl,116,37,147,31,0,1,39,2,0,0,147,31,0,1,39,2,0,0
Cli/14,src_java_org_apache_commons_cli2_option_GroupImpl,220,30,246,26,0,1,32,2,0,0,246,26,0,1,32,2,0,0
Cli/15,src_java_org_apache_commons_cli2_commandline_WriteableCommandLineImpl,111,30,120,9,0,0,32,2,0,0,116,5,1,4,32,2,0,0
Cli/16,src_java_org_apache_commons_cli2_Option,0,14,0,0,0,0,15,1,0,0,0,0,0,0,15,1,0,0
Cli/16,src_java_org_apache_commons_cli2_commandline_WriteableCommandLineImpl,123,30,129,6,0,0,32,2,0,0,129,6,0,0,32,2,0,0
Cli/16,src_java_org_apache_commons_cli2_option_GroupImpl,221,30,247,26,0,0,32,2,0,0,247,26,0,0,32,2,0,0
Cli/16,src_java_org_apache_commons_cli2_option_OptionImpl,72,14,72,0,0,0,15,1,0,0,72,0,0,0,15,1,0,0
Cli/17,src_java_org_apache_commons_cli_PosixParser,71,10,89,18,0,0,12,2,0,0,88,17,1,1,12,2,0,0
Cli/18,src_java_org_apache_commons_cli_PosixParser,43,8,86,43,0,0,11,3,0,0,85,42,0,1,11,3,0,0
Cli/19,src_java_org_apache_commons_cli_PosixParser,78,9,87,9,0,0,11,2,0,0,86,8,0,1,11,2,0,0
Cli/2,src_java_org_apache_commons_cli_PosixParser,72,10,91,19,0,0,12,2,0,0,91,19,0,0,12,2,0,0
Cli/20,src_java_org_apache_commons_cli_PosixParser,51,9,82,31,3,1,11,2,0,0,82,31,2,1,11,2,0,0
Cli/21,src_java_org_apache_commons_cli2_WriteableCommandLine,0,9,0,0,0,0,10,1,0,0,0,0,0,0,10,1,0,0
Cli/21,src_java_org_apache_commons_cli2_commandline_WriteableCommandLineImpl,123,29,134,11,0,0,32,3,0,0,134,11,0,0,32,3,0,0
Cli/21,src_java_org_apache_commons_cli2_option_GroupImpl,248,31,250,2,0,0,33,2,0,0,250,2,0,0,33,2,0,0
Cli/22,src_java_org_apache_commons_cli_PosixParser,9,5,70,61,0,1,10,5,0,0,69,60,1,2,10,5,0,0
Cli/23,src_java_org_apache_commons_cli_HelpFormatter,224,55,242,18,0,1,57,2,0,0,241,17,0,2,57,2,0,0
Cli/24,src_java_org_apache_commons_cli_HelpFormatter,224,55,246,22,0,0,57,2,0,0,245,21,0,1,57,2,0,0
Cli/25,src_java_org_apache_commons_cli_HelpFormatter,224,55,247,23,0,0,57,2,0,0,245,21,0,2,57,2,0,0
Cli/26,src_java_org_apache_commons_cli_OptionBuilder,66,28,77,11,0,0,30,2,0,0,76,10,0,1,30,2,0,0
Cli/27,src_java_org_apache_commons_cli_OptionGroup,34,11,44,10,0,0,13,2,0,0,44,10,0,0,13,2,0,0
Cli/28,src_java_org_apache_commons_cli_Parser,108,14,130,22,0,0,16,2,0,0,129,21,0,1,16,2,0,0
Cli/29,src_java_org_apache_commons_cli_Util,11,1,17,6,0,0,3,2,0,0,17,6,0,0,3,2,0,0
Cli/3,src_java_org_apache_commons_cli_TypeHandler,75,8,83,8,0,0,10,2,0,0,82,7,0,1,10,2,0,0
Cli/30,src_main_java_org_apache_commons_cli_DefaultParser,230,29,251,21,0,0,31,2,0,0,251,21,0,0,31,2,0,0
Cli/30,src_main_java_org_apache_commons_cli_Parser,110,15,134,24,0,0,17,2,0,0,134,24,0,0,17,2,0,0
Cli/31,src_main_java_org_apache_commons_cli_HelpFormatter,238,59,254,16,0,0,61,2,0,0,254,16,0,0,61,2,0,0
Cli/31,src_main_java_org_apache_commons_cli_Option,163,56,163,0,0,0,58,2,0,0,163,0,0,0,58,2,0,0
Cli/31,src_main_java_org_apache_commons_cli_OptionBuilder,72,28,83,11,0,0,30,2,0,0,80,8,0,3,30,2,0,0
Cli/32,src_main_java_org_apache_commons_cli_HelpFormatter,231,59,249,18,0,0,61,2,0,0,249,18,0,0,61,2,0,0
Cli/33,src_main_java_org_apache_commons_cli_HelpFormatter,245,59,249,4,0,0,61,2,0,0,249,4,0,0,61,2,0,0
Cli/34,src_main_java_org_apache_commons_cli_Option,163,56,163,0,0,0,58,2,0,0,163,0,0,0,58,2,0,0
Cli/34,src_main_java_org_apache_commons_cli_OptionBuilder,72,28,83,11,0,0,30,2,0,0,80,8,0,3,30,2,0,0
Cli/35,src_main_java_org_apache_commons_cli_Options,65,20,74,9,0,0,22,2,0,0,74,9,0,0,22,2,0,0
Cli/36,src_main_java_org_apache_commons_cli_OptionGroup,46,11,46,0,0,0,13,2,0,0,46,0,0,0,13,2,0,0
Cli/36,src_main_java_org_apache_commons_cli_Options,77,20,77,0,0,0,22,2,0,0,77,0,0,0,22,2,0,0
Cli/37,src_main_java_org_apache_commons_cli_DefaultParser,253,29,255,2,0,0,31,2,0,0,254,1,0,1,31,2,0,0
Cli/38,src_main_java_org_apache_commons_cli_DefaultParser,253,29,259,6,1,1,31,2,0,0,259,6,0,1,31,2,0,0
Cli/39,src_main_java_org_apache_commons_cli_TypeHandler,41,8,71,30,0,0,10,2,0,0,70,29,0,1,10,2,0,0
Cli/4,src_java_org_apache_commons_cli_Parser,117,11,126,9,0,0,13,2,0,0,126,9,0,0,13,2,0,0
Cli/40,src_main_java_org_apache_commons_cli_TypeHandler,47,9,76,29,0,0,11,2,0,0,75,28,0,1,11,2,0,0
Cli/5,src_java_org_apache_commons_cli_Util,8,1,16,8,0,0,3,2,0,0,16,8,0,0,3,2,0,0
Cli/7,src_java_org_apache_commons_cli2_builder_PatternBuilder,101,10,101,0,0,0,12,2,0,0,101,0,0,0,12,2,0,0
Cli/8,src_java_org_apache_commons_cli_HelpFormatter,217,52,234,17,0,0,54,2,0,0,234,17,0,0,54,2,0,0
Cli/9,src_java_org_apache_commons_cli_Parser,123,14,134,11,0,0,16,2,0,0,134,11,0,0,16,2,0,0
Closure/1,src_com_google_javascript_jscomp_RemoveUnusedVars,418,57,440,22,0,0,59,2,0,0,440,22,0,0,59,2,0,0
Closure/10,src_com_google_javascript_jscomp_NodeUtil,1738,190,1744,6,0,0,192,2,0,0,1744,6,0,0,192,2,0,0
Closure/100,src_com_google_javascript_jscomp_CheckGlobalThis,26,7,58,32,0,0,10,3,0,0,57,31,0,1,10,3,0,0
Closure/101,src_com_google_javascript_jscomp_CommandLineRunner,91,50,106,15,0,1,52,2,0,0,106,15,0,1,52,2,0,0
Closure/102,src_com_google_javascript_jscomp_Normalize,222,35,231,9,0,0,37,2,0,0,231,9,0,0,37,2,0,0
Closure/103,src_com_google_javascript_jscomp_ControlFlowAnalysis,512,54,531,19,0,0,56,2,0,0,531,19,0,0,56,2,0,0
Closure/103,src_com_google_javascript_jscomp_DisambiguateProperties,449,94,469,20,0,0,97,3,0,0,469,20,0,0,97,3,0,0
Closure/104,src_com_google_javascript_rhino_jstype_UnionType,223,31,249,26,0,0,33,2,0,0,248,25,0,1,33,2,0,0
Closure/105,src_com_google_javascript_jscomp_FoldConstants,1185,57,1253,68,0,2,59,2,0,0,1251,66,0,4,59,2,0,0
Closure/106,src_com_google_javascript_jscomp_GlobalNamespace,515,84,523,8,0,0,87,3,0,0,523,8,0,0,87,3,0,0
Closure/106,src_com_google_javascript_rhino_JSDocInfoBuilder,327,54,330,3,0,0,56,2,0,0,330,3,0,0,56,2,0,0
Closure/107,src_com_google_javascript_jscomp_CommandLineRunner,208,101,246,38,0,0,103,2,0,0,246,38,0,0,103,2,0,0
Closure/108,src_com_google_javascript_jscomp_ScopedAliases,172,50,280,108,0,0,55,5,0,0,280,108,0,0,55,5,0,0
Closure/109,src_com_google_javascript_jscomp_parsing_JsDocInfoParser,1483,101,1484,1,0,1,103,2,0,0,1484,1,0,1,103,2,0,0
Closure/11,src_com_google_javascript_jscomp_TypeCheck,880,87,891,11,0,0,89,2,0,0,891,11,0,0,89,2,0,0
Closure/110,src_com_google_javascript_jscomp_ScopedAliases,228,52,261,33,0,0,55,3,0,0,259,31,0,2,55,3,0,0
Closure/110,src_com_google_javascript_rhino_Node,1181,315,1193,12,0,0,317,2,0,0,1193,12,0,0,317,2,0,0
Closure/111,src_com_google_javascript_jscomp_type_ClosureReverseAbstractInterpreter,87,28,89,2,0,0,31,3,0,0,87,0,0,2,30,2,0,1
Closure/112,src_com_google_javascript_jscomp_TypeInference,846,73,859,13,0,0,75,2,0,0,858,12,0,1,75,2,0,0
Closure/113,src_com_google_javascript_jscomp_ProcessClosurePrimitives,578,82,601,23,0,0,84,2,0,0,601,23,0,0,84,2,0,0
Closure/114,src_com_google_javascript_jscomp_NameAnalyzer,858,125,873,15,0,0,128,3,0,0,873,15,0,0,128,3,0,0
Closure/115,src_com_google_javascript_jscomp_FunctionInjector,314,44,348,34,0,0,46,2,0,0,348,34,0,0,46,2,0,0
Closure/116,src_com_google_javascript_jscomp_FunctionInjector,314,44,348,34,0,0,46,2,0,0,348,34,0,0,46,2,0,0
Closure/117,src_com_google_javascript_jscomp_TypeValidator,255,58,291,36,0,0,60,2,0,0,291,36,0,0,60,2,0,0
Closure/118,src_com_google_javascript_jscomp_DisambiguateProperties,539,100,550,11,0,0,103,3,0,0,550,11,0,0,103,3,0,0
Closure/119,src_com_google_javascript_jscomp_GlobalNamespace,551,124,659,108,2,2,127,3,0,0,655,104,6,6,127,3,0,0
Closure/12,src_com_google_javascript_jscomp_MaybeReachingVariableUse,114,19,116,2,0,0,21,2,0,0,116,2,0,0,21,2,0,0
Closure/120,src_com_google_javascript_jscomp_ReferenceCollectingCallback,256,77,270,14,0,0,80,3,0,0,270,14,0,0,80,3,0,0
Closure/121,src_com_google_javascript_jscomp_InlineVariables,269,39,318,49,0,0,42,3,0,0,318,49,0,0,42,3,0,0
Closure/122,src_com_google_javascript_jscomp_parsing_IRFactory,858,109,862,4,0,0,111,2,0,0,861,3,0,1,111,2,0,0
Closure/123,src_com_google_javascript_jscomp_CodeGenerator,365,43,863,498,0,1,45,2,0,0,863,498,0,1,45,2,0,0
Closure/124,src_com_google_javascript_jscomp_ExploitAssigns,100,5,110,10,0,0,7,2,0,0,110,10,0,0,7,2,0,0
Closure/125,src_com_google_javascript_jscomp_TypeCheck,1009,97,1024,15,0,0,99,2,0,0,1024,15,0,0,99,2,0,0
Closure/126,src_com_google_javascript_jscomp_MinimizeExitPoints,79,7,135,56,0,0,9,2,0,0,135,56,0,0,9,2,0,0
Closure/127,src_com_google_javascript_jscomp_UnreachableCodeElimination,74,13,98,24,0,0,16,3,0,0,98,24,0,0,16,3,0,0
Closure/128,src_com_google_javascript_jscomp_CodeGenerator,843,42,852,9,0,0,44,2,0,0,852,9,0,0,44,2,0,0
Closure/129,src_com_google_javascript_jscomp_PrepareAst,75,14,84,9,0,0,17,3,0,0,84,9,0,0,17,3,0,0
Closure/13,src_com_google_javascript_jscomp_PeepholeOptimizationsPass,79,26,96,17,0,0,28,2,0,0,96,17,0,0,28,2,0,0
Closure/130,src_com_google_javascript_jscomp_CollapseProperties,383,31,404,21,0,0,33,2,0,0,404,21,0,0,33,2,0,0
Closure/131,src_com_google_javascript_rhino_TokenStream,321,1,332,11,0,0,3,2,0,0,332,11,0,0,3,2,0,0
Closure/132,src_com_google_javascript_jscomp_PeepholeSubstituteAlternateSyntax,817,61,956,139,0,0,63,2,0,0,956,139,0,0,63,2,0,0
Closure/133,src_com_google_javascript_jscomp_parsing_JsDocInfoParser,1412,91,1415,3,0,0,93,2,0,0,1415,3,0,0,93,2,0,0
Closure/134,src_com_google_javascript_jscomp_AmbiguateProperties,221,61,276,55,0,0,68,7,0,0,276,55,0,0,68,7,0,0
Closure/134,src_com_google_javascript_jscomp_TypedScopeCreator,595,56,601,6,0,0,59,3,0,0,601,6,0,0,59,3,0,0
Closure/135,src_com_google_javascript_jscomp_DevirtualizePrototypeMethods,126,11,138,12,0,0,13,2,0,0,138,12,0,0,13,2,0,0
Closure/135,src_com_google_javascript_rhino_jstype_FunctionType,359,59,369,10,0,0,61,2,0,0,369,10,0,0,61,2,0,0
Closure/136,src_com_google_javascript_jscomp_MethodCompilerPass,87,19,93,6,0,0,21,2,0,0,93,6,0,0,21,2,0,0
Closure/136,src_com_google_javascript_jscomp_RenameVars,149,42,186,37,0,0,45,3,0,0,186,37,0,0,45,3,0,0
Closure/137,src_com_google_javascript_jscomp_MakeDeclaredNamesUnique,135,39,163,28,3,2,51,12,0,0,156,21,7,9,51,12,0,0
Closure/137,src_com_google_javascript_jscomp_NodeUtil,990,120,990,0,0,0,121,1,0,0,990,0,0,0,121,1,0,0
Closure/137,src_com_google_javascript_jscomp_Normalize,230,40,239,9,0,0,42,2,0,0,239,9,0,0,42,2,0,0
Closure/138,src_com_google_javascript_jscomp_ClosureReverseAbstractInterpreter,70,28,87,17,0,0,30,2,0,0,85,15,2,2,30,2,0,0
Closure/138,src_com_google_javascript_jscomp_TypeInference,639,57,658,19,0,0,59,2,0,0,657,18,1,1,59,2,0,0
Closure/139,src_com_google_javascript_jscomp_Normalize,214,32,241,27,0,0,43,11,0,0,241,27,0,0,43,11,0,0
Closure/14,src_com_google_javascript_jscomp_ControlFlowAnalysis,498,58,562,64,0,0,60,2,0,0,562,64,0,0,60,2,0,0
Closure/140,src_com_google_javascript_jscomp_Compiler,740,182,766,26,0,0,186,4,0,0,766,26,0,0,186,4,0,0
Closure/141,src_com_google_javascript_jscomp_NodeUtil,978,120,994,16,0,0,122,2,0,0,994,16,0,0,122,2,0,0
Closure/141,src_com_google_javascript_jscomp_PureFunctionIdentifier,295,49,313,18,0,0,51,2,0,0,306,11,6,7,51,2,0,0
Closure/142,src_com_google_javascript_jscomp_CoalesceVariableNames,177,34,189,12,0,0,36,2,0,0,189,12,0,0,36,2,0,0
Closure/142,src_com_google_javascript_jscomp_parsing_JsDocInfoParser,1098,76,1159,61,0,0,78,2,0,0,1156,58,3,3,78,2,0,0
Closure/143,src_com_google_javascript_jscomp_AbstractCommandLineRunner,521,101,556,35,0,0,103,2,0,0,556,35,0,0,103,2,0,0
Closure/143,src_com_google_javascript_jscomp_RemoveConstantExpressions,25,13,33,8,0,0,16,3,0,0,33,8,0,0,16,3,0,0
Closure/144,src_com_google_javascript_jscomp_FunctionTypeBuilder,204,42,236,32,0,0,45,3,0,0,236,32,0,0,45,3,0,0
Closure/144,src_com_google_javascript_jscomp_TypedScopeCreator,613,70,666,53,0,0,73,3,0,0,666,53,0,0,73,3,0,0
Closure/144,src_com_google_javascript_rhino_jstype_FunctionBuilder,45,23,45,0,0,0,24,1,0,0,45,0,0,0,24,1,0,0
Closure/144,src_com_google_javascript_rhino_jstype_FunctionType,404,64,406,2,0,0,66,2,0,0,405,1,0,1,66,2,0,0
Closure/145,src_com_google_javascript_jscomp_CodeGenerator,676,33,678,2,0,0,35,2,0,0,678,2,0,0,35,2,0,0
Closure/146,src_com_google_javascript_rhino_jstype_JSType,279,96,291,12,0,0,98,2,0,0,291,12,0,0,98,2,0,0
Closure/147,src_com_google_javascript_jscomp_CheckGlobalThis,31,8,62,31,0,0,10,2,0,0,62,31,0,0,10,2,0,0
Closure/147,src_com_google_javascript_jscomp_RuntimeTypeCheck,139,23,163,24,0,0,28,5,0,0,163,24,0,0,28,5,0,0
Closure/148,src_com_google_javascript_jscomp_PeepholeFoldConstants,737,26,772,35,0,0,28,2,0,0,771,34,1,1,28,2,0,0
Closure/148,src_com_google_javascript_jscomp_SourceMap,34,23,156,122,2,2,39,16,0,0,104,70,5,54,37,14,0,2
Closure/149,src_com_google_javascript_jscomp_AbstractCommandLineRunner,586,114,642,56,0,0,118,4,0,0,642,56,0,0,118,4,0,0
Closure/149,src_com_google_javascript_jscomp_CommandLineRunner,104,56,119,15,0,0,58,2,0,0,119,15,0,0,58,2,0,0
Closure/149,src_com_google_javascript_jscomp_Compiler,828,195,836,8,0,1,197,2,0,0,836,8,0,1,197,2,0,0
Closure/149,src_com_google_javascript_jscomp_CompilerOptions,212,178,212,0,0,0,180,2,0,0,212,0,0,0,180,2,0,0
Closure/15,src_com_google_javascript_jscomp_FlowSensitiveInlineVariables,176,31,192,16,0,0,34,3,0,0,176,0,0,16,33,2,0,1
Closure/150,src_com_google_javascript_jscomp_TypedScopeCreator,688,79,695,7,0,0,82,3,0,0,695,7,0,0,82,3,0,0
Closure/151,src_com_google_javascript_jscomp_CommandLineRunner,86,55,119,33,0,0,58,3,0,0,119,33,0,0,58,3,0,0
Closure/152,src_com_google_javascript_rhino_jstype_FunctionType,409,64,430,21,0,0,66,2,0,0,430,21,0,0,66,2,0,0
Closure/154,src_com_google_javascript_jscomp_TypeCheck,817,82,858,41,0,0,86,4,0,0,858,41,0,0,86,4,0,0
Closure/154,src_com_google_javascript_jscomp_TypeValidator,259,52,268,9,0,0,56,4,0,0,268,9,0,0,56,4,0,0
Closure/155,src_com_google_javascript_jscomp_InlineVariables,221,36,289,68,0,0,40,4,0,0,289,68,0,0,40,4,0,0
Closure/155,src_com_google_javascript_jscomp_ReferenceCollectingCallback,219,65,229,10,0,0,67,2,0,0,228,9,0,1,67,2,0,0
Closure/155,src_com_google_javascript_jscomp_Scope,163,59,163,0,0,0,60,1,0,0,163,0,0,0,60,1,0,0
Closure/156,src_com_google_javascript_jscomp_CollapseProperties,270,26,365,95,0,0,32,6,0,0,364,94,1,1,32,6,0,0
Closure/157,src_com_google_javascript_jscomp_CodeGenerator,272,35,747,475,0,0,37,2,0,0,747,475,0,0,37,2,0,0
Closure/157,src_com_google_javascript_jscomp_RenamePrototypes,136,31,185,49,0,0,35,4,0,0,183,47,0,2,35,4,0,0
Closure/157,src_com_google_javascript_jscomp_parsing_IRFactory,811,89,820,9,2,1,92,3,0,0,820,9,2,1,92,3,0,0
Closure/158,src_com_google_javascript_jscomp_AbstractCommandLineRunner,664,130,707,43,0,2,133,3,0,0,707,43,0,2,133,3,0,0
Closure/158,src_com_google_javascript_jscomp_CommandLineRunner,114,59,156,42,0,0,66,7,0,0,156,42,0,0,66,7,0,0
Closure/158,src_com_google_javascript_jscomp_DiagnosticGroups,16,29,20,4,0,0,31,2,0,0,20,4,0,0,31,2,0,0
Closure/159,src_com_google_javascript_jscomp_InlineFunctions,477,122,486,9,0,0,124,2,0,0,484,7,2,2,124,2,0,0
Closure/16,src_com_google_javascript_jscomp_ScopedAliases,196,46,218,22,0,0,52,6,0,0,218,22,0,0,52,6,0,0
Closure/160,src_com_google_javascript_jscomp_Compiler,894,204,921,27,0,3,206,2,0,0,920,26,0,4,206,2,0,0
Closure/161,src_com_google_javascript_jscomp_PeepholeFoldConstants,901,36,932,31,0,0,38,2,0,0,932,31,0,0,38,2,0,0
Closure/164,src_com_google_javascript_rhino_jstype_ArrowType,84,17,116,32,0,0,19,2,0,0,116,32,0,0,19,2,0,0
Closure/165,src_com_google_javascript_rhino_jstype_JSTypeRegistry,587,104,597,10,0,0,106,2,0,0,597,10,0,0,106,2,0,0
Closure/165,src_com_google_javascript_rhino_jstype_ObjectType,178,75,178,0,0,0,76,1,0,0,178,0,0,0,76,1,0,0
Closure/165,src_com_google_javascript_rhino_jstype_RecordType,52,9,116,64,0,0,13,4,0,0,106,54,0,10,13,4,0,0
Closure/165,src_com_google_javascript_rhino_jstype_RecordTypeBuilder,16,11,21,5,0,0,13,2,0,0,21,5,0,0,13,2,0,0
Closure/166,src_com_google_javascript_rhino_jstype_PrototypeObjectType,279,49,286,7,0,0,51,2,0,0,286,7,0,0,51,2,0,0
Closure/167,src_com_google_javascript_jscomp_type_SemanticReverseAbstractInterpreter,239,32,315,76,0,0,38,6,0,0,312,73,0,3,38,6,0,0
Closure/167,src_com_google_javascript_rhino_jstype_JSType,402,123,409,7,0,0,125,2,0,0,409,7,0,0,125,2,0,0
Closure/168,src_com_google_javascript_jscomp_TypedScopeCreator,890,100,925,35,0,0,105,5,0,0,925,35,0,0,105,5,0,0
Closure/169,src_com_google_javascript_rhino_jstype_ArrowType,111,18,135,24,0,0,21,3,0,0,135,24,0,0,21,3,0,0
Closure/169,src_com_google_javascript_rhino_jstype_FunctionType,546,82,586,40,0,0,86,4,0,0,586,40,0,0,86,4,0,0
Closure/169,src_com_google_javascript_rhino_jstype_JSType,416,125,471,55,0,0,130,5,0,0,465,49,3,6,130,5,0,0
Closure/169,src_com_google_javascript_rhino_jstype_RecordType,52,12,117,65,0,0,16,4,0,0,113,61,4,4,16,4,0,0
Closure/169,src_com_google_javascript_rhino_jstype_UnionType,326,40,343,17,0,0,43,3,0,0,343,17,0,0,43,3,0,0
Closure/17,src_com_google_javascript_jscomp_TypedScopeCreator,873,102,910,37,0,0,105,3,0,0,910,37,0,0,105,3,0,0
Closure/170,src_com_google_javascript_jscomp_FlowSensitiveInlineVariables,201,32,209,8,0,0,36,4,0,0,208,7,0,1,35,3,0,1
Closure/171,src_com_google_javascript_jscomp_TypeInference,814,73,848,34,0,0,75,2,0,0,848,34,0,0,75,2,0,0
Closure/171,src_com_google_javascript_jscomp_TypedScopeCreator,967,106,992,25,0,0,109,3,0,0,992,25,0,0,109,3,0,0
Closure/172,src_com_google_javascript_jscomp_TypedScopeCreator,967,106,995,28,0,0,109,3,0,0,995,28,0,0,109,3,0,0
Closure/173,src_com_google_javascript_jscomp_CodeGenerator,365,43,859,494,0,0,45,2,0,0,855,490,4,4,45,2,0,0
Closure/173,src_com_google_javascript_jscomp_PeepholeSubstituteAlternateSyntax,331,26,360,29,0,0,28,2,0,0,360,29,0,0,28,2,0,0
Closure/175,src_com_google_javascript_jscomp_FunctionInjector,294,43,333,39,1,0,46,3,0,0,331,37,4,2,46,3,0,0
Closure/18,src_com_google_javascript_jscomp_Compiler,1094,239,1175,81,0,0,241,2,0,0,1175,81,0,0,241,2,0,0
Closure/19,src_com_google_javascript_jscomp_type_ChainableReverseAbstractInterpreter,249,89,263,14,0,0,91,2,0,0,263,14,0,0,91,2,0,0
Closure/2,src_com_google_javascript_jscomp_TypeCheck,924,91,940,16,0,0,93,2,0,0,940,16,0,0,93,2,0,0
Closure/20,src_com_google_javascript_jscomp_PeepholeSubstituteAlternateSyntax,943,60,956,13,0,0,62,2,0,0,956,13,0,0,62,2,0,0
Closure/21,src_com_google_javascript_jscomp_CheckSideEffects,47,16,75,28,0,0,18,2,0,0,75,28,0,0,18,2,0,0
Closure/22,src_com_google_javascript_jscomp_CheckSideEffects,47,16,71,24,2,4,18,2,0,0,69,22,4,6,18,2,0,0
Closure/23,src_com_google_javascript_jscomp_PeepholeFoldConstants,997,42,1032,35,0,1,44,2,0,0,1032,35,0,1,44,2,0,0
Closure/24,src_com_google_javascript_jscomp_ScopedAliases,165,45,181,16,0,0,48,3,0,0,180,15,2,1,48,3,0,0
Closure/25,src_com_google_javascript_jscomp_TypeInference,727,62,747,20,1,1,64,2,0,0,748,21,0,0,64,2,0,0
Closure/26,src_com_google_javascript_jscomp_ProcessCommonJSModules,92,25,103,11,0,0,29,4,0,0,103,11,0,0,29,4,0,0
Closure/27,src_com_google_javascript_rhino_IR,335,69,345,10,0,0,72,3,0,0,345,10,0,0,72,3,0,0
Closure/28,src_com_google_javascript_jscomp_InlineCostEstimator,26,16,26,0,0,0,18,2,0,0,26,0,0,0,18,2,0,0
Closure/29,src_com_google_javascript_jscomp_InlineObjectLiterals,150,15,191,41,0,0,18,3,0,0,191,41,0,0,18,3,0,0
Closure/3,src_com_google_javascript_jscomp_FlowSensitiveInlineVariables,124,31,205,81,0,0,36,5,0,0,205,81,0,0,36,5,0,0
Closure/30,src_com_google_javascript_jscomp_FlowSensitiveInlineVariables,187,32,189,2,0,0,34,2,0,0,189,2,0,0,34,2,0,0
Closure/30,src_com_google_javascript_jscomp_MustBeReachingVariableDef,190,25,208,18,0,0,30,5,0,0,207,17,0,1,29,4,0,1
Closure/31,src_com_google_javascript_jscomp_Compiler,1045,233,1145,100,0,0,235,2,0,0,1145,100,0,0,235,2,0,0
Closure/32,src_com_google_javascript_jscomp_parsing_JsDocInfoParser,1295,89,1356,61,0,0,91,2,0,0,1354,59,1,2,91,2,0,0
Closure/33,src_com_google_javascript_rhino_jstype_PrototypeObjectType,268,48,281,13,0,0,50,2,0,0,281,13,0,0,50,2,0,0
Closure/34,src_com_google_javascript_jscomp_CodeGenerator,308,37,803,495,0,1,40,3,0,0,802,494,0,2,40,3,0,0
Closure/34,src_com_google_javascript_jscomp_CodePrinter,261,80,271,10,0,0,83,3,0,0,271,10,0,0,83,3,0,0
Closure/35,src_com_google_javascript_jscomp_TypeInference,750,62,755,5,0,2,64,2,0,0,755,5,0,2,64,2,0,0
Closure/36,src_com_google_javascript_jscomp_InlineVariables,283,39,309,26,0,0,42,3,0,0,309,26,0,0,42,3,0,0
Closure/37,src_com_google_javascript_jscomp_NodeTraversal,247,70,266,19,0,0,72,2,0,0,266,19,0,0,72,2,0,0
Closure/37,src_com_google_javascript_jscomp_parsing_IRFactory,714,96,753,39,0,0,99,3,0,0,753,39,0,0,99,3,0,0
Closure/38,src_com_google_javascript_jscomp_CodeConsumer,105,35,129,24,0,0,37,2,0,0,129,24,0,0,37,2,0,0
Closure/39,src_com_google_javascript_rhino_jstype_PrototypeObjectType,236,47,268,32,0,0,49,2,0,0,266,30,0,2,49,2,0,0
Closure/4,src_com_google_javascript_rhino_jstype_NamedType,142,33,161,19,0,0,35,2,0,0,161,19,0,0,35,2,0,0
Closure/40,src_com_google_javascript_jscomp_NameAnalyzer,775,121,816,41,0,0,124,3,0,0,815,40,0,1,124,3,0,0
Closure/41,src_com_google_javascript_jscomp_FunctionTypeBuilder,294,77,378,84,0,0,80,3,0,0,378,84,0,0,80,3,0,0
Closure/42,src_com_google_javascript_jscomp_parsing_IRFactory,747,96,749,2,0,0,99,3,0,0,749,2,0,0,99,3,0,0
Closure/43,src_com_google_javascript_jscomp_TypedScopeCreator,812,100,871,59,0,0,104,4,0,0,871,59,0,0,104,4,0,0
Closure/44,src_com_google_javascript_jscomp_CodeConsumer,115,35,125,10,0,0,37,2,0,0,125,10,0,0,37,2,0,0
Closure/45,src_com_google_javascript_jscomp_RemoveUnusedVars,389,55,429,40,0,1,59,4,0,0,429,40,0,1,59,4,0,0
Closure/46,src_com_google_javascript_rhino_jstype_RecordType,116,12,116,0,0,0,13,1,0,0,116,0,0,0,13,1,0,0
Closure/47,src_com_google_debugging_sourcemap_SourceMapConsumerV3,325,76,335,10,0,0,78,2,0,0,334,9,0,1,78,2,0,0
Closure/47,src_com_google_javascript_jscomp_SourceMap,49,24,57,8,0,0,26,2,0,0,57,8,0,0,26,2,0,0
Closure/48,src_com_google_javascript_jscomp_TypedScopeCreator,798,100,856,58,0,0,103,3,0,0,854,56,0,2,103,3,0,0
Closure/49,src_com_google_javascript_jscomp_MakeDeclaredNamesUnique,171,62,221,50,3,8,66,4,0,0,218,47,5,11,66,4,0,0
Closure/5,src_com_google_javascript_jscomp_InlineObjectLiterals,150,15,201,51,0,0,18,3,0,0,201,51,0,0,18,3,0,0
Closure/50,src_com_google_javascript_jscomp_PeepholeReplaceKnownMethods,314,14,400,86,0,0,16,2,0,0,400,86,0,0,16,2,0,0
Closure/51,src_com_google_javascript_jscomp_CodeConsumer,100,34,123,23,0,0,36,2,0,0,123,23,0,0,36,2,0,0
Closure/52,src_com_google_javascript_jscomp_CodeGenerator,777,39,786,9,0,0,41,2,0,0,786,9,0,0,41,2,0,0
Closure/53,src_com_google_javascript_jscomp_InlineObjectLiterals,151,15,187,36,0,0,18,3,0,0,184,33,3,3,18,3,0,0
Closure/54,src_com_google_javascript_jscomp_TypedScopeCreator,745,90,800,55,0,0,93,3,0,0,800,55,0,0,93,3,0,0
Closure/54,src_com_google_javascript_rhino_jstype_FunctionType,467,71,500,33,0,0,74,3,0,0,499,32,0,1,74,3,0,0
Closure/55,src_com_google_javascript_jscomp_FunctionRewriter,180,53,182,2,0,0,55,2,0,0,182,2,0,0,55,2,0,0
Closure/56,src_com_google_javascript_jscomp_SourceFile,157,59,184,27,0,0,61,2,0,0,184,27,0,0,61,2,0,0
Closure/57,src_com_google_javascript_jscomp_ClosureCodingConvention,162,25,177,15,0,0,27,2,0,0,177,15,0,0,27,2,0,0
Closure/58,src_com_google_javascript_jscomp_LiveVariablesAnalysis,74,24,142,68,0,0,26,2,0,0,142,68,0,0,26,2,0,0
Closure/59,src_com_google_javascript_jscomp_Compiler,915,207,949,34,0,0,209,2,0,0,949,34,0,0,209,2,0,0
Closure/6,src_com_google_javascript_jscomp_TypeValidator,266,57,285,19,0,0,60,3,0,0,283,17,2,2,60,3,0,0
Closure/60,src_com_google_javascript_jscomp_NodeUtil,1498,188,1562,64,0,0,191,3,0,0,1562,64,0,0,191,3,0,0
Closure/61,src_com_google_javascript_jscomp_NodeUtil,1522,189,1555,33,0,0,191,2,0,0,1555,33,0,0,191,2,0,0
Closure/62,src_com_google_javascript_jscomp_LightweightMessageFormatter,57,11,90,33,0,0,13,2,0,0,90,33,0,0,13,2,0,0
Closure/64,src_com_google_javascript_jscomp_Compiler,878,201,925,47,0,0,206,5,0,0,924,46,0,1,205,4,0,1
Closure/65,src_com_google_javascript_jscomp_CodeGenerator,723,39,786,63,0,0,41,2,0,0,786,63,0,0,41,2,0,0
Closure/66,src_com_google_javascript_jscomp_TypeCheck,641,87,914,273,0,0,89,2,0,0,914,273,0,0,89,2,0,0
Closure/67,src_com_google_javascript_jscomp_AnalyzePrototypeProperties,253,84,265,12,0,0,87,3,0,0,265,12,0,0,87,3,0,0
Closure/68,src_com_google_javascript_jscomp_parsing_JsDocInfoParser,706,85,1325,619,0,0,89,4,0,0,1325,619,0,0,89,4,0,0
Closure/69,src_com_google_javascript_jscomp_TypeCheck,886,87,911,25,0,0,89,2,0,0,911,25,0,0,89,2,0,0
Closure/7,src_com_google_javascript_jscomp_type_ChainableReverseAbstractInterpreter,259,88,266,7,0,0,91,3,0,0,265,6,0,1,91,3,0,0
Closure/70,src_com_google_javascript_jscomp_TypedScopeCreator,833,91,851,18,0,0,94,3,0,0,850,17,0,1,94,3,0,0
Closure/71,src_com_google_javascript_jscomp_CheckAccessControls,227,39,274,47,0,0,41,2,0,0,274,47,0,0,41,2,0,0
Closure/72,src_com_google_javascript_jscomp_FunctionToBlockMutator,161,18,164,3,0,0,20,2,0,0,164,3,0,0,20,2,0,0
Closure/72,src_com_google_javascript_jscomp_RenameLabels,61,25,82,21,0,0,28,3,0,0,82,21,0,0,28,3,0,0
Closure/73,src_com_google_javascript_jscomp_CodeGenerator,713,37,776,63,0,0,39,2,0,0,776,63,0,0,39,2,0,0
Closure/74,src_com_google_javascript_jscomp_PeepholeFoldConstants,999,42,1140,141,0,0,44,2,0,0,1138,139,0,2,44,2,0,0
Closure/75,src_com_google_javascript_jscomp_NodeUtil,1518,184,1555,37,2,2,187,3,0,0,1555,37,2,2,187,3,0,0
Closure/76,src_com_google_javascript_jscomp_DeadAssignmentsElimination,137,14,184,47,0,1,17,3,0,0,182,45,2,3,17,3,0,0
Closure/77,src_com_google_javascript_jscomp_CodeGenerator,684,35,744,60,0,0,37,2,0,0,736,52,8,8,37,2,0,0
Closure/78,src_com_google_javascript_jscomp_PeepholeFoldConstants,1026,41,1088,62,0,0,43,2,0,0,1088,62,0,0,43,2,0,0
Closure/79,src_com_google_javascript_jscomp_Normalize,321,48,333,12,0,0,50,2,0,0,333,12,0,0,50,2,0,0
Closure/79,src_com_google_javascript_jscomp_VarCheck,106,21,113,7,0,0,23,2,0,0,113,7,0,0,23,2,0,0
Closure/8,src_com_google_javascript_jscomp_CollapseVariableDeclarations,79,14,90,11,0,0,17,3,0,0,90,11,0,0,17,3,0,0
Closure/80,src_com_google_javascript_jscomp_NodeUtil,1497,184,1556,59,0,0,187,3,0,0,1556,59,0,0,187,3,0,0
Closure/81,src_com_google_javascript_jscomp_parsing_IRFactory,768,82,801,33,0,0,85,3,0,0,801,33,0,0,85,3,0,0
Closure/82,src_com_google_javascript_rhino_jstype_JSType,328,102,330,2,0,0,104,2,0,0,330,2,0,0,104,2,0,0
Closure/83,src_com_google_javascript_jscomp_CommandLineRunner,107,57,125,18,0,0,61,4,0,0,124,17,0,1,61,4,0,0
Closure/84,src_com_google_javascript_jscomp_parsing_IRFactory,749,77,765,16,0,0,81,4,0,0,765,16,0,0,81,4,0,0
Closure/85,src_com_google_javascript_jscomp_UnreachableCodeElimination,55,11,84,29,0,0,14,3,0,0,82,27,1,2,14,3,0,0
Closure/86,src_com_google_javascript_jscomp_NodeUtil,1239,153,1277,38,3,3,155,2,0,0,1277,38,2,3,155,2,0,0
Closure/87,src_com_google_javascript_jscomp_PeepholeSubstituteAlternateSyntax,557,33,565,8,0,0,35,2,0,0,564,7,0,1,35,2,0,0
Closure/88,src_com_google_javascript_jscomp_DeadAssignmentsElimination,142,14,159,17,0,0,16,2,0,0,159,17,0,0,16,2,0,0
Closure/89,src_com_google_javascript_jscomp_CollapseProperties,315,30,339,24,0,0,32,2,0,0,339,24,0,0,32,2,0,0
Closure/89,src_com_google_javascript_jscomp_GlobalNamespace,512,85,530,18,0,0,88,3,0,0,530,18,0,0,88,3,0,0
Closure/9,src_com_google_javascript_jscomp_ProcessCommonJSModules,87,27,107,20,0,0,31,4,0,0,107,20,0,0,31,4,0,0
Closure/90,src_com_google_javascript_jscomp_FunctionTypeBuilder,317,52,323,6,0,0,55,3,0,0,323,6,0,0,55,3,0,0
Closure/90,src_com_google_javascript_rhino_jstype_FunctionType,409,64,433,24,0,0,66,2,0,0,433,24,0,0,66,2,0,0
Closure/91,src_com_google_javascript_jscomp_CheckGlobalThis,31,8,62,31,0,0,10,2,0,0,62,31,0,0,10,2,0,0
Closure/92,src_com_google_javascript_jscomp_ProcessClosurePrimitives,401,60,447,46,0,0,63,3,0,0,447,46,0,0,63,3,0,0
Closure/94,src_com_google_javascript_jscomp_NodeUtil,1142,141,1162,20,0,0,143,2,0,0,1162,20,0,0,143,2,0,0
Closure/95,src_com_google_javascript_jscomp_TypedScopeCreator,667,81,705,38,0,0,84,3,0,0,705,38,0,0,84,3,0,0
Closure/96,src_com_google_javascript_jscomp_TypeCheck,804,82,823,19,0,0,84,2,0,0,823,19,0,0,84,2,0,0
Closure/97,src_com_google_javascript_jscomp_PeepholeFoldConstants,734,26,775,41,0,0,28,2,0,0,775,41,0,0,28,2,0,0
Closure/98,src_com_google_javascript_jscomp_ReferenceCollectingCallback,203,59,212,9,0,0,64,5,0,0,212,9,0,0,64,5,0,0
Closure/99,src_com_google_javascript_jscomp_CheckGlobalThis,31,8,59,28,0,0,10,2,0,0,57,26,1,2,10,2,0,0
Codec/1,src_java_org_apache_commons_codec_language_Caverphone,11,4,75,64,0,0,6,2,0,0,75,64,0,0,6,2,0,0
Codec/1,src_java_org_apache_commons_codec_language_Metaphone,38,15,244,206,0,0,17,2,0,0,244,206,0,0,17,2,0,0
Codec/1,src_java_org_apache_commons_codec_language_SoundexUtils,14,2,30,16,0,0,4,2,0,0,30,16,0,0,4,2,0,0
Codec/10,src_java_org_apache_commons_codec_language_Caverphone,11,4,75,64,0,0,6,2,0,0,75,64,0,0,6,2,0,0
Codec/12,src_main_java_org_apache_commons_codec_binary_BaseNCodecInputStream,44,7,44,0,0,0,8,1,0,0,44,0,0,0,8,1,0,0
Codec/13,src_main_java_org_apache_commons_codec_binary_StringUtils,51,17,52,1,0,0,18,1,0,0,52,1,0,0,18,1,0,0
Codec/13,src_main_java_org_apache_commons_codec_language_DoubleMetaphone,613,59,615,2,0,0,61,2,0,0,615,2,1,0,61,2,0,0
Codec/14,src_main_java_org_apache_commons_codec_language_bm_Lang,71,14,75,4,0,0,16,2,0,0,71,0,0,4,16,2,0,0
Codec/14,src_main_java_org_apache_commons_codec_language_bm_PhoneticEngine,170,38,196,26,0,0,40,2,0,0,192,22,0,4,40,2,0,0
Codec/14,src_main_java_org_apache_commons_codec_language_bm_Rule,300,63,322,22,0,0,66,3,0,0,302,2,0,20,66,3,0,0
Codec/16,src_main_java_org_apache_commons_codec_binary_Base32,198,24,198,0,0,0,26,2,0,0,198,0,0,0,26,2,0,0
Codec/17,src_main_java_org_apache_commons_codec_binary_StringUtils,67,19,69,2,0,0,21,2,0,0,69,2,0,0,21,2,0,0
Codec/2,src_java_org_apache_commons_codec_binary_Base64,247,51,302,55,0,0,53,2,0,0,302,55,0,0,53,2,0,0
Codec/3,src_java_org_apache_commons_codec_language_DoubleMetaphone,581,65,627,46,0,0,67,2,0,0,627,46,0,0,67,2,0,0
Codec/4,src_java_org_apache_commons_codec_binary_Base64,324,60,326,2,0,0,62,2,0,0,325,1,0,1,62,2,0,0
Codec/5,src_java_org_apache_commons_codec_binary_Base64,284,61,326,42,0,0,63,2,0,0,326,42,0,0,63,2,0,0
Codec/6,src_java_org_apache_commons_codec_binary_Base64InputStream,21,8,48,27,0,0,10,2,0,0,45,24,2,3,10,2,0,0
Codec/7,src_java_org_apache_commons_codec_binary_Base64,327,61,329,2,0,0,63,2,0,0,329,2,0,0,63,2,0,0
Codec/8,src_java_org_apache_commons_codec_binary_Base64,308,61,308,0,0,0,62,1,0,0,308,0,0,0,62,1,0,0
Codec/8,src_java_org_apache_commons_codec_binary_Base64InputStream,21,8,49,28,0,0,10,2,0,0,49,28,0,0,10,2,0,0
Codec/9,src_java_org_apache_commons_codec_binary_Base64,302,62,312,10,0,0,64,2,0,0,311,9,0,1,64,2,0,0
Collections/25,src_main_java_org_apache_commons_collections4_IteratorUtils,324,72,330,6,0,0,76,4,0,0,330,6,0,0,76,4,0,0
Collections/26,src_main_java_org_apache_commons_collections4_keyvalue_MultiKey,48,16,51,3,0,0,18,2,0,0,51,3,0,0,18,2,0,0
Collections/27,src_main_java_org_apache_commons_collections4_map_MultiValueMap,168,46,168,0,0,0,48,2,0,0,168,0,0,0,48,2,0,0
Collections/28,src_main_java_org_apache_commons_collections4_trie_AbstractPatriciaTrie,1141,214,1141,0,0,0,216,2,0,0,1141,0,0,0,216,2,0,0
Compress/1,src_main_java_org_apache_commons_compress_archivers_cpio_CpioArchiveOutputStream,189,26,194,5,0,0,28,2,0,0,194,5,0,0,28,2,0,0
Compress/10,src_main_java_org_apache_commons_compress_archivers_zip_ZipFile,308,65,340,32,0,0,67,2,0,0,340,32,0,0,67,2,0,0
Compress/11,src_main_java_org_apache_commons_compress_archivers_ArchiveStreamFactory,49,8,97,48,0,0,10,2,0,0,97,48,0,0,10,2,0,0
Compress/12,src_main_java_org_apache_commons_compress_archivers_tar_TarArchiveInputStream,201,30,248,47,0,0,32,2,0,0,248,47,0,0,32,2,0,0
Compress/13,src_main_java_org_apache_commons_compress_archivers_zip_ZipArchiveEntry,226,56,228,2,0,0,58,2,0,0,228,2,0,0,58,2,0,0
Compress/14,src_main_java_org_apache_commons_compress_archivers_tar_TarUtils,96,13,132,36,0,0,15,2,0,0,131,35,0,1,15,2,0,0
Compress/15,src_main_java_org_apache_commons_compress_archivers_zip_ZipArchiveEntry,202,56,227,25,0,0,58,2,0,0,225,23,0,2,58,2,0,0
Compress/16,src_main_java_org_apache_commons_compress_archivers_ArchiveStreamFactory,49,8,98,49,0,0,10,2,0,0,98,49,0,0,10,2,0,0
Compress/17,src_main_java_org_apache_commons_compress_archivers_tar_TarUtils,205,25,240,35,0,0,27,2,0,0,240,35,0,0,27,2,0,0
Compress/18,src_main_java_org_apache_commons_compress_archivers_tar_TarArchiveOutputStream,199,48,224,25,0,0,50,2,0,0,224,25,0,0,50,2,0,0
Compress/19,src_main_java_org_apache_commons_compress_archivers_zip_Zip64ExtendedInformationExtraField,101,25,125,24,0,0,27,2,0,0,125,24,0,0,27,2,0,0
Compress/2,src_main_java_org_apache_commons_compress_archivers_ar_ArArchiveInputStream,36,7,90,54,0,1,12,5,0,0,89,53,1,2,12,5,0,0
Compress/20,src_main_java_org_apache_commons_compress_archivers_cpio_CpioArchiveInputStream,189,28,262,73,0,0,32,4,0,0,262,73,0,0,32,4,0,0
Compress/21,src_main_java_org_apache_commons_compress_archivers_sevenz_SevenZOutputFile,414,46,428,14,0,0,48,2,0,0,426,12,0,2,48,2,0,0
Compress/22,src_main_java_org_apache_commons_compress_compressors_bzip2_BZip2CompressorInputStream,542,71,624,82,0,0,78,7,0,0,624,82,0,0,78,7,0,0
Compress/23,src_main_java_org_apache_commons_compress_archivers_sevenz_Coders,114,32,123,9,0,1,35,3,0,0,122,8,0,2,35,3,0,0
Compress/24,src_main_java_org_apache_commons_compress_archivers_tar_TarUtils,205,25,237,32,0,0,27,2,0,0,237,32,0,0,27,2,0,0
Compress/25,src_main_java_org_apache_commons_compress_archivers_zip_ZipArchiveInputStream,471,72,476,5,0,0,74,2,0,0,476,5,0,0,74,2,0,0
Compress/26,src_main_java_org_apache_commons_compress_utils_IOUtils,38,9,48,10,0,0,11,2,0,0,48,10,0,0,11,2,0,0
Compress/27,src_main_java_org_apache_commons_compress_archivers_tar_TarUtils,205,25,235,30,0,0,27,2,0,0,235,30,0,0,27,2,0,0
Compress/28,src_main_java_org_apache_commons_compress_archivers_tar_TarArchiveInputStream,260,40,277,17,0,0,42,2,0,0,277,17,0,0,42,2,0,0
Compress/29,src_main_java_org_apache_commons_compress_archivers_ArchiveStreamFactory,69,15,179,110,0,0,18,3,0,0,178,109,1,1,18,3,0,0
Compress/29,src_main_java_org_apache_commons_compress_archivers_cpio_CpioArchiveInputStream,255,33,259,4,0,0,35,2,0,0,259,4,0,0,35,2,0,0
Compress/29,src_main_java_org_apache_commons_compress_archivers_cpio_CpioArchiveOutputStream,245,30,258,13,0,0,32,2,0,0,258,13,0,0,32,2,0,0
Compress/29,src_main_java_org_apache_commons_compress_archivers_dump_DumpArchiveInputStream,226,30,246,20,0,0,32,2,0,0,246,20,0,0,32,2,0,0
Compress/29,src_main_java_org_apache_commons_compress_archivers_tar_TarArchiveInputStream,280,42,286,6,0,0,44,2,0,0,286,6,0,0,44,2,0,0
Compress/29,src_main_java_org_apache_commons_compress_archivers_tar_TarArchiveOutputStream,258,58,266,8,0,0,60,2,0,0,266,8,0,0,60,2,0,0
Compress/29,src_main_java_org_apache_commons_compress_archivers_zip_ZipArchiveInputStream,471,72,477,6,0,0,74,2,0,0,477,6,0,0,74,2,0,0
Compress/3,src_main_java_org_apache_commons_compress_archivers_tar_TarArchiveOutputStream,63,23,103,40,0,0,27,4,0,0,103,40,0,0,27,4,0,0
Compress/30,src_main_java_org_apache_commons_compress_compressors_bzip2_BZip2CompressorInputStream,607,76,629,22,0,0,78,2,0,0,629,22,0,0,78,2,0,0
Compress/31,src_main_java_org_apache_commons_compress_archivers_tar_TarUtils,204,25,234,30,0,0,27,2,0,0,234,30,0,0,27,2,0,0
Compress/32,src_main_java_org_apache_commons_compress_archivers_tar_TarArchiveInputStream,252,43,287,35,0,0,45,2,0,0,287,35,0,0,45,2,0,0
Compress/33,src_main_java_org_apache_commons_compress_compressors_CompressorStreamFactory,72,17,109,37,0,0,19,2,0,0,109,37,0,0,19,2,0,0
Compress/33,src_main_java_org_apache_commons_compress_compressors_deflate_DeflateCompressorInputStream,18,8,18,0,0,0,9,1,0,0,18,0,0,0,9,1,0,0
Compress/34,src_main_java_org_apache_commons_compress_archivers_zip_X7875_NewUnix,82,23,83,1,0,1,25,2,0,0,83,1,0,1,25,2,0,0
Compress/35,src_main_java_org_apache_commons_compress_archivers_tar_TarUtils,214,25,227,13,0,1,27,2,0,0,227,13,0,1,27,2,0,0
Compress/36,src_main_java_org_apache_commons_compress_archivers_sevenz_SevenZFile,694,38,704,10,0,0,40,2,0,0,704,10,0,0,40,2,0,0
Compress/37,src_main_java_org_apache_commons_compress_archivers_tar_TarArchiveInputStream,272,46,312,40,0,0,48,2,0,0,310,38,2,2,48,2,0,0
Compress/38,src_main_java_org_apache_commons_compress_archivers_tar_TarArchiveEntry,360,100,371,11,0,0,102,2,0,0,371,11,0,0,102,2,0,0
Compress/39,src_main_java_org_apache_commons_compress_utils_ArchiveUtils,82,13,98,16,0,0,15,2,0,0,98,16,0,0,15,2,0,0
Compress/4,src_main_java_org_apache_commons_compress_archivers_cpio_CpioArchiveOutputStream,178,24,183,5,0,0,26,2,0,0,183,5,0,0,26,2,0,0
Compress/4,src_main_java_org_apache_commons_compress_archivers_tar_TarArchiveOutputStream,101,26,107,6,0,0,28,2,0,0,107,6,0,0,28,2,0,0
Compress/4,src_main_java_org_apache_commons_compress_archivers_zip_ZipArchiveOutputStream,307,71,314,7,0,0,73,2,0,0,314,7,0,0,73,2,0,0
Compress/4,src_main_java_org_apache_commons_compress_changes_ChangeSetPerformer,22,4,72,50,0,0,6,2,0,0,72,50,0,0,6,2,0,0
Compress/40,src_main_java_org_apache_commons_compress_utils_BitInputStream,8,9,37,29,1,1,11,2,0,0,32,24,2,6,11,2,0,0
Compress/41,src_main_java_org_apache_commons_compress_archivers_zip_ZipArchiveInputStream,409,74,489,80,0,0,76,2,0,0,488,79,0,1,76,2,0,0
Compress/42,src_main_java_org_apache_commons_compress_archivers_zip_UnixStat,0,7,0,0,0,0,8,1,0,0,0,0,0,0,8,1,0,0
Compress/42,src_main_java_org_apache_commons_compress_archivers_zip_ZipArchiveEntry,286,77,288,2,0,0,79,2,0,0,288,2,0,0,79,2,0,0
Compress/43,src_main_java_org_apache_commons_compress_archivers_zip_ZipArchiveOutputStream,477,144,558,81,0,0,149,5,0,0,557,80,0,1,149,5,0,0
Compress/44,src_main_java_org_apache_commons_compress_utils_ChecksumCalculatingInputStream,21,7,24,3,0,0,9,2,0,0,24,3,0,0,9,2,0,0
Compress/45,src_main_java_org_apache_commons_compress_archivers_tar_TarUtils,218,25,230,12,0,0,27,2,0,0,230,12,0,0,27,2,0,0
Compress/46,src_main_java_org_apache_commons_compress_archivers_zip_X5455_ExtendedTimestamp,143,44,148,5,0,0,46,2,0,0,147,4,0,1,46,2,0,0
Compress/47,src_main_java_org_apache_commons_compress_archivers_zip_ZipArchiveInputStream,474,73,510,36,0,0,76,3,0,0,510,36,0,0,76,3,0,0
Compress/5,src_main_java_org_apache_commons_compress_archivers_zip_ZipArchiveInputStream,140,27,190,50,0,0,29,2,0,0,189,49,1,1,29,2,0,0
Compress/6,src_main_java_org_apache_commons_compress_archivers_zip_ZipArchiveEntry,147,43,166,19,0,0,46,3,0,0,165,18,0,1,46,3,0,0
Compress/7,src_main_java_org_apache_commons_compress_archivers_tar_TarUtils,75,9,85,10,0,0,11,2,0,0,85,10,0,0,11,2,0,0
Compress/9,src_main_java_org_apache_commons_compress_archivers_tar_TarArchiveOutputStream,94,27,127,33,0,0,29,2,0,0,127,33,0,0,29,2,0,0
Csv/1,src_main_java_org_apache_commons_csv_ExtendedBufferedReader,45,10,52,7,0,0,12,2,0,0,51,6,0,1,12,2,0,0
Csv/10,src_main_java_org_apache_commons_csv_CSVPrinter,204,17,210,6,0,0,19,2,0,0,210,6,0,0,19,2,0,0
Csv/11,src_main_java_org_apache_commons_csv_CSVParser,117,25,147,30,0,0,27,2,0,0,147,30,0,0,27,2,0,0
Csv/12,src_main_java_org_apache_commons_csv_CSVFormat,260,60,260,0,0,0,62,2,0,0,260,0,0,0,62,2,0,0
Csv/13,src_main_java_org_apache_commons_csv_CSVFormat,314,79,314,0,0,0,81,2,0,0,314,0,0,0,81,2,0,0
Csv/13,src_main_java_org_apache_commons_csv_CSVPrinter,206,17,219,13,0,0,19,2,0,0,219,13,0,0,19,2,0,0
Csv/14,src_main_java_org_apache_commons_csv_CSVFormat,421,100,494,73,0,0,102,2,0,0,494,73,0,0,102,2,0,0
Csv/15,src_main_java_org_apache_commons_csv_CSVFormat,436,106,507,71,0,0,108,2,0,0,505,69,2,2,108,2,0,0
Csv/16,src_main_java_org_apache_commons_csv_CSVParser,153,29,162,9,0,1,32,3,0,0,162,9,0,1,32,3,0,0
Csv/2,src_main_java_org_apache_commons_csv_CSVRecord,25,17,31,6,0,0,19,2,0,0,31,6,0,0,19,2,0,0
Csv/3,src_main_java_org_apache_commons_csv_Lexer,40,22,63,23,0,0,24,2,0,0,63,23,0,0,24,2,0,0
Csv/4,src_main_java_org_apache_commons_csv_CSVParser,137,24,139,2,0,0,26,2,0,0,139,2,0,0,26,2,0,0
Csv/5,src_main_java_org_apache_commons_csv_CSVPrinter,202,17,206,4,0,0,19,2,0,0,206,4,0,0,19,2,0,0
Csv/6,src_main_java_org_apache_commons_csv_CSVRecord,44,21,50,6,0,0,23,2,0,0,50,6,0,0,23,2,0,0
Csv/7,src_main_java_org_apache_commons_csv_CSVParser,118,25,142,24,0,0,27,2,0,0,142,24,0,0,27,2,0,0
Csv/8,src_main_java_org_apache_commons_csv_CSVFormat,208,55,246,38,0,4,58,3,0,0,246,38,0,4,58,3,0,0
Csv/9,src_main_java_org_apache_commons_csv_CSVRecord,44,21,52,8,0,0,23,2,0,0,52,8,0,0,23,2,0,0
Gson/1,gson_src_main_java_com_google_gson_TypeInfoFactory,23,5,60,37,0,0,7,2,0,0,60,37,0,0,7,2,0,0
Gson/10,gson_src_main_java_com_google_gson_internal_bind_ReflectiveTypeAdapterFactory,125,25,141,16,0,0,28,3,0,0,140,15,0,1,27,2,0,1
Gson/11,gson_src_main_java_com_google_gson_internal_bind_TypeAdapters,527,139,537,10,0,0,142,3,0,0,527,0,0,10,141,2,0,1
Gson/12,gson_src_main_java_com_google_gson_internal_bind_JsonTreeReader,201,31,210,9,0,0,33,2,0,0,210,9,0,0,33,2,0,0
Gson/13,gson_src_main_java_com_google_gson_stream_JsonReader,918,81,1012,94,0,0,83,2,0,0,1008,90,0,4,83,2,0,0
Gson/14,gson_src_main_java_com_google_gson_internal_$Gson$Types,307,50,315,8,0,0,53,3,0,0,315,8,0,0,53,3,0,0
Gson/15,gson_src_main_java_com_google_gson_stream_JsonWriter,229,43,257,28,0,0,45,2,0,0,236,7,0,21,45,2,0,0
Gson/16,gson_src_main_java_com_google_gson_internal_$Gson$Types,265,52,325,60,0,0,54,2,0,0,325,60,0,0,54,2,0,0
Gson/17,gson_src_main_java_com_google_gson_DefaultDateTypeAdapter,47,13,60,13,0,2,15,2,0,0,60,13,0,2,15,2,0,0
Gson/18,gson_src_main_java_com_google_gson_internal_$Gson$Types,327,52,330,3,0,0,54,2,0,0,330,3,0,0,54,2,0,0
Gson/2,gson_src_main_java_com_google_gson_internal_bind_TypeAdapters,485,121,492,7,0,1,124,3,0,0,491,6,0,2,123,2,0,1
Gson/3,gson_src_main_java_com_google_gson_internal_ConstructorConstructor,83,19,111,28,0,0,21,2,0,0,111,28,0,0,21,2,0,0
Gson/4,gson_src_main_java_com_google_gson_stream_JsonReader,859,82,988,129,0,0,84,2,0,0,984,125,0,4,84,2,0,0
Gson/4,gson_src_main_java_com_google_gson_stream_JsonWriter,143,34,249,106,0,0,44,10,0,0,229,86,0,20,44,10,0,0
Gson/5,gson_src_main_java_com_google_gson_internal_bind_util_ISO8601Utils,76,9,187,111,0,0,11,2,0,0,187,111,0,0,11,2,0,0
Gson/6,gson_src_main_java_com_google_gson_internal_bind_JsonAdapterAnnotationTypeAdapterFactory,8,3,23,15,0,0,5,2,0,0,23,15,0,0,5,2,0,0
Gson/7,gson_src_main_java_com_google_gson_stream_JsonReader,907,81,988,81,0,0,84,3,0,0,984,77,0,4,84,3,0,0
Gson/8,gson_src_main_java_com_google_gson_internal_UnsafeAllocator,2,2,34,32,0,0,7,5,0,0,28,26,0,6,4,2,0,3
Gson/9,gson_src_main_java_com_google_gson_internal_bind_JsonTreeWriter,112,25,112,0,0,0,26,1,0,0,112,0,0,0,26,1,0,0
Gson/9,gson_src_main_java_com_google_gson_internal_bind_TypeAdapters,535,139,537,2,0,0,142,3,0,0,535,0,0,2,141,2,0,1
Gson/9,gson_src_main_java_com_google_gson_stream_JsonWriter,229,43,249,20,0,0,44,1,0,0,229,0,0,20,44,1,0,0
JacksonCore/1,src_main_java_com_fasterxml_jackson_core_io_NumberInput,201,15,205,4,0,0,18,3,0,0,205,4,0,0,18,3,0,0
JacksonCore/1,src_main_java_com_fasterxml_jackson_core_util_TextBuffer,322,44,333,11,0,0,46,2,0,0,331,9,0,2,46,2,0,0
JacksonCore/10,src_main_java_com_fasterxml_jackson_core_sym_ByteQuadsCanonicalizer,583,77,613,30,1,1,80,3,0,0,613,30,1,1,80,3,0,0
JacksonCore/11,src_main_java_com_fasterxml_jackson_core_sym_ByteQuadsCanonicalizer,609,78,618,9,0,0,80,2,0,0,618,9,0,0,80,2,0,0
JacksonCore/12,src_main_java_com_fasterxml_jackson_core_json_ReaderBasedJsonParser,1624,78,1973,349,0,0,85,7,0,0,1973,349,0,0,85,7,0,0
JacksonCore/12,src_main_java_com_fasterxml_jackson_core_json_UTF8StreamJsonParser,2580,112,2586,6,0,0,114,2,0,0,2586,6,0,0,114,2,0,0
JacksonCore/13,src_main_java_com_fasterxml_jackson_core_json_JsonGeneratorImpl,39,17,39,0,0,0,18,1,0,0,39,0,0,0,18,1,0,0
JacksonCore/14,src_main_java_com_fasterxml_jackson_core_io_IOContext,84,33,94,10,0,0,37,4,0,0,94,10,0,0,37,4,0,0
JacksonCore/15,src_main_java_com_fasterxml_jackson_core_filter_FilteringParserDelegate,400,62,561,161,0,0,64,2,0,0,561,161,0,0,64,2,0,0
JacksonCore/17,src_main_java_com_fasterxml_jackson_core_json_UTF8JsonGenerator,1239,95,1273,34,0,1,99,4,0,0,1271,32,0,3,99,4,0,0
JacksonCore/18,src_main_java_com_fasterxml_jackson_core_base_GeneratorBase,155,47,157,2,0,0,50,3,0,0,157,2,0,0,50,3,0,0
JacksonCore/18,src_main_java_com_fasterxml_jackson_core_json_UTF8JsonGenerator,1305,98,1315,10,0,0,100,2,0,0,1315,10,0,0,100,2,0,0
JacksonCore/18,src_main_java_com_fasterxml_jackson_core_json_WriterBasedJsonGenerator,1255,74,1265,10,0,0,76,2,0,0,1265,10,0,0,76,2,0,0
JacksonCore/19,src_main_java_com_fasterxml_jackson_core_json_ReaderBasedJsonParser,1887,83,1984,97,0,0,85,2,0,0,1980,93,4,4,85,2,0,0
JacksonCore/19,src_main_java_com_fasterxml_jackson_core_json_UTF8StreamJsonParser,2514,112,2588,74,0,0,114,2,0,0,2584,70,4,4,114,2,0,0
JacksonCore/2,src_main_java_com_fasterxml_jackson_core_json_ReaderBasedJsonParser,1146,57,1346,200,0,0,61,4,0,0,1346,200,0,0,61,4,0,0
JacksonCore/2,src_main_java_com_fasterxml_jackson_core_json_UTF8StreamJsonParser,1976,87,2201,225,0,0,93,6,0,0,2201,225,0,0,93,6,0,0
JacksonCore/20,src_main_java_com_fasterxml_jackson_core_JsonGenerator,338,112,340,2,0,0,114,2,0,0,339,1,0,1,114,2,0,0
JacksonCore/21,src_main_java_com_fasterxml_jackson_core_filter_FilteringParserDelegate,406,64,580,174,0,0,66,2,0,0,576,170,4,4,66,2,0,0
JacksonCore/22,src_main_java_com_fasterxml_jackson_core_filter_FilteringParserDelegate,166,62,573,407,0,0,66,4,0,0,567,401,6,6,66,4,0,0
JacksonCore/23,src_main_java_com_fasterxml_jackson_core_util_DefaultPrettyPrinter,120,45,122,2,0,0,47,2,0,0,122,2,0,0,47,2,0,0
JacksonCore/25,src_main_java_com_fasterxml_jackson_core_json_ReaderBasedJsonParser,2026,91,2062,36,0,0,93,2,0,0,2062,36,0,0,93,2,0,0
JacksonCore/26,src_main_java_com_fasterxml_jackson_core_json_async_NonBlockingJsonParser,2133,76,2149,16,0,0,78,2,0,0,2149,16,0,0,78,2,0,0
JacksonCore/3,src_main_java_com_fasterxml_jackson_core_json_UTF8StreamJsonParser,2218,93,2227,9,0,0,95,2,0,0,2227,9,0,0,95,2,0,0
JacksonCore/4,src_main_java_com_fasterxml_jackson_core_util_TextBuffer,338,45,342,4,0,1,47,2,0,0,342,4,0,1,47,2,0,0
JacksonCore/5,src_main_java_com_fasterxml_jackson_core_JsonPointer,97,23,115,18,0,0,25,2,0,0,115,18,0,0,25,2,0,0
JacksonCore/6,src_main_java_com_fasterxml_jackson_core_JsonPointer,97,23,115,18,0,0,25,2,0,0,114,17,0,1,25,2,0,0
JacksonCore/7,src_main_java_com_fasterxml_jackson_core_json_JsonWriteContext,84,28,97,13,0,0,30,2,0,0,95,11,2,2,30,2,0,0
JacksonCore/8,src_main_java_com_fasterxml_jackson_core_util_TextBuffer,344,46,355,11,0,0,48,2,0,0,355,11,0,0,48,2,0,0
JacksonCore/9,src_main_java_com_fasterxml_jackson_core_base_ParserMinimalBase,279,70,292,13,0,0,73,3,0,0,292,13,0,0,73,3,0,0
JacksonCore/9,src_main_java_com_fasterxml_jackson_core_json_ReaderBasedJsonParser,1606,69,1624,18,0,0,72,3,0,0,1624,18,0,0,72,3,0,0
JacksonCore/9,src_main_java_com_fasterxml_jackson_core_json_UTF8StreamJsonParser,2539,106,2557,18,0,0,109,3,0,0,2557,18,0,0,109,3,0,0
JacksonDatabind/1,src_main_java_com_fasterxml_jackson_databind_ser_BeanPropertyWriter,236,56,274,38,0,0,58,2,0,0,274,38,0,0,58,2,0,0
JacksonDatabind/10,src_main_java_com_fasterxml_jackson_databind_ser_AnyGetterWriter,0,3,29,29,0,1,8,5,0,0,30,30,0,0,8,5,0,0
JacksonDatabind/10,src_main_java_com_fasterxml_jackson_databind_ser_BeanSerializerFactory,276,21,328,52,0,1,23,2,0,0,328,52,0,1,23,2,0,0
JacksonDatabind/100,src_main_java_com_fasterxml_jackson_databind_node_TreeTraversingParser,170,38,176,6,0,0,40,2,0,0,175,5,0,1,40,2,0,0
JacksonDatabind/101,src_main_java_com_fasterxml_jackson_databind_deser_BeanDeserializer,558,39,626,68,0,0,41,2,0,0,626,68,0,0,41,2,0,0
JacksonDatabind/102,src_main_java_com_fasterxml_jackson_databind_ser_std_DateTimeSerializerBase,39,13,87,48,0,0,15,2,0,0,87,48,0,0,15,2,0,0
JacksonDatabind/103,src_main_java_com_fasterxml_jackson_databind_DatabindContext,82,25,102,20,0,0,27,2,0,0,102,20,0,0,27,2,0,0
JacksonDatabind/103,src_main_java_com_fasterxml_jackson_databind_DeserializationContext,465,106,485,20,0,0,109,3,0,0,485,20,0,0,109,3,0,0
JacksonDatabind/103,src_main_java_com_fasterxml_jackson_databind_JsonMappingException,156,52,178,22,0,0,55,3,0,0,177,21,0,1,55,3,0,0
JacksonDatabind/103,src_main_java_com_fasterxml_jackson_databind_SerializerProvider,404,84,429,25,0,0,87,3,0,0,429,25,0,0,87,3,0,0
JacksonDatabind/103,src_main_java_com_fasterxml_jackson_databind_deser_BasicDeserializerFactory,1111,69,1152,41,0,0,71,2,0,0,1138,27,0,14,71,2,0,0
JacksonDatabind/103,src_main_java_com_fasterxml_jackson_databind_deser_BeanDeserializerFactory,372,24,442,70,0,0,27,3,0,0,442,70,0,0,27,3,0,0
JacksonDatabind/103,src_main_java_com_fasterxml_jackson_databind_deser_DeserializerCache,222,22,242,20,0,0,24,2,0,0,242,20,0,0,24,2,0,0
JacksonDatabind/103,src_main_java_com_fasterxml_jackson_databind_deser_SettableAnyProperty,73,27,91,18,0,0,29,2,0,0,90,17,0,1,29,2,0,0
JacksonDatabind/103,src_main_java_com_fasterxml_jackson_databind_deser_SettableBeanProperty,237,88,255,18,0,0,91,3,0,0,254,17,0,1,91,3,0,0
JacksonDatabind/103,src_main_java_com_fasterxml_jackson_databind_deser_std_StdDeserializer,584,66,593,9,0,0,68,2,0,0,593,9,0,0,68,2,0,0
JacksonDatabind/103,src_main_java_com_fasterxml_jackson_databind_deser_std_StdKeyDeserializer,236,62,254,18,0,0,65,3,0,0,254,18,0,0,65,3,0,0
JacksonDatabind/103,src_main_java_com_fasterxml_jackson_databind_deser_std_StdValueInstantiator,217,62,224,7,0,0,64,2,0,0,224,7,0,0,64,2,0,0
JacksonDatabind/103,src_main_java_com_fasterxml_jackson_databind_introspect_BasicBeanDescription,327,53,346,19,0,0,55,2,0,0,346,19,0,0,55,2,0,0
JacksonDatabind/103,src_main_java_com_fasterxml_jackson_databind_ser_DefaultSerializerProvider,258,33,278,20,0,0,36,3,0,0,277,19,0,1,36,3,0,0
JacksonDatabind/103,src_main_java_com_fasterxml_jackson_databind_ser_PropertyBuilder,62,14,161,99,0,0,16,2,0,0,161,99,0,0,16,2,0,0
JacksonDatabind/103,src_main_java_com_fasterxml_jackson_databind_util_ClassUtil,573,94,573,0,0,0,95,1,0,0,573,0,0,0,95,1,0,0
JacksonDatabind/104,src_main_java_com_fasterxml_jackson_databind_util_StdDateFormat,276,57,334,58,0,0,60,3,0,0,319,43,0,15,60,3,0,0
JacksonDatabind/105,src_main_java_com_fasterxml_jackson_databind_deser_std_JdkDeserializers,0,1,28,28,0,0,3,2,0,0,20,20,0,8,3,2,0,0
JacksonDatabind/106,src_main_java_com_fasterxml_jackson_databind_node_TreeTraversingParser,175,37,181,6,0,0,40,3,0,0,181,6,0,0,40,3,0,0
JacksonDatabind/107,src_main_java_com_fasterxml_jackson_databind_jsontype_impl_TypeDeserializerBase,78,24,102,24,0,0,26,2,0,0,102,24,0,0,26,2,0,0
JacksonDatabind/108,src_main_java_com_fasterxml_jackson_databind_ObjectReader,633,139,635,2,0,0,141,2,0,0,635,2,0,0,141,2,0,0
JacksonDatabind/109,src_main_java_com_fasterxml_jackson_databind_ser_std_NumberSerializer,36,5,45,9,0,0,8,3,0,0,45,9,0,0,8,3,0,0
JacksonDatabind/109,src_main_java_com_fasterxml_jackson_databind_ser_std_NumberSerializers,55,31,64,9,0,0,34,3,0,0,64,9,0,0,34,3,0,0
JacksonDatabind/11,src_main_java_com_fasterxml_jackson_databind_type_TypeFactory,446,67,458,12,0,0,69,2,0,0,457,11,0,1,69,2,0,0
JacksonDatabind/110,src_main_java_com_fasterxml_jackson_databind_deser_impl_JavaUtilCollectionsDeserializers,54,24,84,30,0,0,26,2,0,0,74,20,0,10,26,2,0,0
JacksonDatabind/111,src_main_java_com_fasterxml_jackson_databind_deser_CreatorProperty,77,28,82,5,0,0,30,2,0,0,82,5,0,0,30,2,0,0
JacksonDatabind/111,src_main_java_com_fasterxml_jackson_databind_deser_impl_FieldProperty,98,18,103,5,0,0,20,2,0,0,103,5,0,0,20,2,0,0
JacksonDatabind/111,src_main_java_com_fasterxml_jackson_databind_deser_impl_MethodProperty,96,18,101,5,0,0,20,2,0,0,101,5,0,0,20,2,0,0
JacksonDatabind/111,src_main_java_com_fasterxml_jackson_databind_deser_impl_ObjectIdReferenceProperty,52,20,57,5,0,0,22,2,0,0,57,5,0,0,22,2,0,0
JacksonDatabind/111,src_main_java_com_fasterxml_jackson_databind_deser_impl_ObjectIdValueProperty,39,13,44,5,0,0,15,2,0,0,44,5,0,0,15,2,0,0
JacksonDatabind/111,src_main_java_com_fasterxml_jackson_databind_deser_impl_SetterlessProperty,49,15,54,5,0,0,17,2,0,0,54,5,0,0,17,2,0,0
JacksonDatabind/111,src_main_java_com_fasterxml_jackson_databind_deser_std_AtomicReferenceDeserializer,15,8,17,2,0,0,10,2,0,0,17,2,0,0,10,2,0,0
JacksonDatabind/112,src_main_java_com_fasterxml_jackson_databind_deser_std_StringCollectionDeserializer,99,15,124,25,0,0,17,2,0,0,124,25,0,0,17,2,0,0
JacksonDatabind/12,src_main_java_com_fasterxml_jackson_databind_deser_std_MapDeserializer,334,46,336,2,0,0,48,2,0,0,336,2,0,0,48,2,0,0
JacksonDatabind/13,src_main_java_com_fasterxml_jackson_databind_deser_DefaultDeserializationContext,108,23,137,29,0,0,25,2,0,0,137,29,0,0,25,2,0,0
JacksonDatabind/13,src_main_java_com_fasterxml_jackson_databind_deser_impl_ObjectIdValueProperty,29,13,38,9,0,0,15,2,0,0,38,9,0,0,15,2,0,0
JacksonDatabind/14,src_main_java_com_fasterxml_jackson_databind_ObjectReader,541,122,557,16,0,0,124,2,0,0,556,15,0,1,124,2,0,0
JacksonDatabind/15,src_main_java_com_fasterxml_jackson_databind_JavaType,102,51,102,0,0,0,52,1,0,0,102,0,0,0,52,1,0,0
JacksonDatabind/15,src_main_java_com_fasterxml_jackson_databind_ser_BeanSerializerFactory,302,21,332,30,0,0,23,2,0,0,332,30,0,0,23,2,0,0
JacksonDatabind/15,src_main_java_com_fasterxml_jackson_databind_ser_std_BeanSerializerBase,416,34,431,15,0,0,36,2,0,0,431,15,0,0,36,2,0,0
JacksonDatabind/15,src_main_java_com_fasterxml_jackson_databind_ser_std_StdDelegatingSerializer,40,13,71,31,0,0,20,7,0,0,71,31,0,0,20,7,0,0
JacksonDatabind/15,src_main_java_com_fasterxml_jackson_databind_ser_std_StdSerializer,77,17,94,17,0,0,19,2,0,0,94,17,0,0,19,2,0,0
JacksonDatabind/16,src_main_java_com_fasterxml_jackson_databind_introspect_AnnotationMap,43,10,49,6,0,0,12,2,0,0,49,6,0,0,12,2,0,0
JacksonDatabind/17,src_main_java_com_fasterxml_jackson_databind_ObjectMapper,847,231,862,15,0,0,236,5,0,0,862,15,0,0,236,5,0,0
JacksonDatabind/19,src_main_java_com_fasterxml_jackson_databind_type_TypeFactory,487,68,496,9,0,0,70,2,0,0,496,9,0,0,70,2,0,0
JacksonDatabind/2,src_main_java_com_fasterxml_jackson_databind_util_TokenBuffer,825,161,830,5,0,0,164,3,0,0,829,4,0,1,164,3,0,0
JacksonDatabind/20,src_main_java_com_fasterxml_jackson_databind_node_ObjectNode,247,61,256,9,0,0,63,2,0,0,256,9,0,0,63,2,0,0
JacksonDatabind/21,src_main_java_com_fasterxml_jackson_databind_introspect_JacksonAnnotationIntrospector,464,77,474,10,0,0,79,2,0,0,474,10,0,0,79,2,0,0
JacksonDatabind/22,src_main_java_com_fasterxml_jackson_databind_ser_BasicSerializerFactory,311,39,495,184,1,1,44,5,0,0,436,125,26,60,44,5,0,0
JacksonDatabind/22,src_main_java_com_fasterxml_jackson_databind_ser_BeanSerializerFactory,312,22,356,44,0,0,24,2,0,0,351,39,3,5,24,2,0,0
JacksonDatabind/23,src_main_java_com_fasterxml_jackson_databind_ser_std_NumberSerializers,72,26,76,4,0,0,36,10,0,0,76,4,0,0,36,10,0,0
JacksonDatabind/24,src_main_java_com_fasterxml_jackson_databind_cfg_BaseSettings,97,37,102,5,0,0,39,2,0,0,102,5,0,0,39,2,0,0
JacksonDatabind/25,src_main_java_com_fasterxml_jackson_databind_deser_BasicDeserializerFactory,986,63,1049,63,0,0,65,2,0,0,1035,49,0,14,65,2,0,0
JacksonDatabind/25,src_main_java_com_fasterxml_jackson_databind_deser_DeserializerCache,189,22,250,61,0,0,24,2,0,0,250,61,0,0,24,2,0,0
JacksonDatabind/25,src_main_java_com_fasterxml_jackson_databind_jsontype_impl_TypeDeserializerBase,80,22,98,18,0,0,24,2,0,0,98,18,0,0,24,2,0,0
JacksonDatabind/25,src_main_java_com_fasterxml_jackson_databind_module_SimpleAbstractTypeResolver,14,4,21,7,0,0,6,2,0,0,20,6,0,1,6,2,0,0
JacksonDatabind/26,src_main_java_com_fasterxml_jackson_databind_ser_BeanPropertyWriter,356,72,356,0,0,0,73,1,0,0,356,0,0,0,73,1,0,0
JacksonDatabind/27,src_main_java_com_fasterxml_jackson_databind_deser_BeanDeserializer,480,25,542,62,0,0,27,2,0,0,542,62,0,0,27,2,0,0
JacksonDatabind/29,src_main_java_com_fasterxml_jackson_databind_deser_impl_ExternalTypeHandler,147,26,169,22,0,0,29,3,0,0,169,22,0,0,29,3,0,0
JacksonDatabind/3,src_main_java_com_fasterxml_jackson_databind_deser_std_StringArrayDeserializer,34,8,79,45,0,2,11,3,0,0,78,44,0,3,11,3,0,0
JacksonDatabind/30,src_main_java_com_fasterxml_jackson_databind_ObjectMapper,897,256,940,43,0,0,259,3,0,0,940,43,0,0,259,3,0,0
JacksonDatabind/30,src_main_java_com_fasterxml_jackson_databind_util_TokenBuffer,813,161,887,74,0,0,165,4,0,0,886,73,1,1,165,4,0,0
JacksonDatabind/31,src_main_java_com_fasterxml_jackson_databind_util_TokenBuffer,813,148,895,82,0,0,167,19,0,0,877,64,0,18,167,19,0,0
JacksonDatabind/32,src_main_java_com_fasterxml_jackson_databind_deser_std_UntypedObjectDeserializer,280,27,372,92,0,0,33,6,0,0,372,92,0,0,33,6,0,0
JacksonDatabind/33,src_main_java_com_fasterxml_jackson_databind_introspect_JacksonAnnotationIntrospector,509,78,526,17,0,0,80,2,0,0,526,17,0,0,80,2,0,0
JacksonDatabind/34,src_main_java_com_fasterxml_jackson_databind_ser_std_NumberSerializer,29,5,40,11,0,0,7,2,0,0,40,11,0,0,7,2,0,0
JacksonDatabind/35,src_main_java_com_fasterxml_jackson_databind_jsontype_impl_AsWrapperTypeDeserializer,16,9,43,27,2,2,11,2,0,0,43,27,2,2,11,2,0,0
JacksonDatabind/36,src_main_java_com_fasterxml_jackson_databind_util_StdDateFormat,236,41,263,27,0,0,44,3,0,0,252,16,0,11,44,3,0,0
JacksonDatabind/37,src_main_java_com_fasterxml_jackson_databind_type_SimpleType,92,21,97,5,0,0,23,2,0,0,97,5,0,0,23,2,0,0
JacksonDatabind/38,src_main_java_com_fasterxml_jackson_databind_type_CollectionType,30,13,32,2,0,0,15,2,0,0,31,1,0,1,15,2,0,0
JacksonDatabind/38,src_main_java_com_fasterxml_jackson_databind_type_MapType,39,16,41,2,0,0,18,2,0,0,40,1,0,1,18,2,0,0
JacksonDatabind/38,src_main_java_com_fasterxml_jackson_databind_type_SimpleType,82,20,97,15,0,0,23,3,0,0,97,15,0,0,23,3,0,0
JacksonDatabind/39,src_main_java_com_fasterxml_jackson_databind_deser_std_NullifyingDeserializer,10,4,13,3,0,0,6,2,0,0,13,3,0,0,6,2,0,0
JacksonDatabind/4,src_main_java_com_fasterxml_jackson_databind_deser_std_StringArrayDeserializer,34,8,81,47,0,0,11,3,0,0,81,47,0,0,11,3,0,0
JacksonDatabind/40,src_main_java_com_fasterxml_jackson_databind_deser_std_NumberDeserializers,286,74,291,5,0,0,76,2,0,0,286,0,0,5,76,2,0,0
JacksonDatabind/42,src_main_java_com_fasterxml_jackson_databind_deser_std_FromStringDeserializer,157,23,162,5,0,0,26,3,0,0,162,5,0,0,26,3,0,0
JacksonDatabind/43,src_main_java_com_fasterxml_jackson_databind_deser_impl_ObjectIdValueProperty,27,12,39,12,0,0,14,2,0,0,38,11,0,1,14,2,0,0
JacksonDatabind/44,src_main_java_com_fasterxml_jackson_databind_type_SimpleType,102,22,107,5,0,0,24,2,0,0,107,5,0,0,24,2,0,0
JacksonDatabind/45,src_main_java_com_fasterxml_jackson_databind_ser_std_DateTimeSerializerBase,29,12,51,22,0,0,14,2,0,0,50,21,0,1,14,2,0,0
JacksonDatabind/46,src_main_java_com_fasterxml_jackson_databind_type_ReferenceType,65,20,71,6,0,0,22,2,0,0,71,6,0,0,22,2,0,0
JacksonDatabind/47,src_main_java_com_fasterxml_jackson_databind_AnnotationIntrospector,206,88,270,64,0,0,90,2,0,0,270,64,0,0,90,2,0,0
JacksonDatabind/48,src_main_java_com_fasterxml_jackson_databind_DeserializationConfig,329,78,341,12,0,0,80,2,0,0,341,12,0,0,80,2,0,0
JacksonDatabind/48,src_main_java_com_fasterxml_jackson_databind_SerializationConfig,357,81,369,12,0,0,83,2,0,0,369,12,0,0,83,2,0,0
JacksonDatabind/49,src_main_java_com_fasterxml_jackson_databind_ser_impl_WritableObjectId,23,6,26,3,0,0,8,2,0,0,26,3,0,0,8,2,0,0
JacksonDatabind/5,src_main_java_com_fasterxml_jackson_databind_introspect_AnnotatedClass,499,64,516,17,0,0,66,2,0,0,516,17,0,0,66,2,0,0
JacksonDatabind/50,src_main_java_com_fasterxml_jackson_databind_deser_BeanDeserializer,486,29,565,79,0,0,32,3,0,0,559,73,6,6,32,3,0,0
JacksonDatabind/51,src_main_java_com_fasterxml_jackson_databind_jsontype_impl_TypeDeserializerBase,77,22,99,22,0,0,24,2,0,0,99,22,0,0,24,2,0,0
JacksonDatabind/52,src_main_java_com_fasterxml_jackson_databind_deser_BeanDeserializerBase,665,83,756,91,0,0,85,2,0,0,756,91,0,0,85,2,0,0
JacksonDatabind/52,src_main_java_com_fasterxml_jackson_databind_deser_impl_ExternalTypeHandler,183,29,185,2,0,0,32,3,0,0,185,2,0,0,32,3,0,0
JacksonDatabind/53,src_main_java_com_fasterxml_jackson_databind_type_TypeBindings,185,39,200,15,0,0,41,2,0,0,200,15,0,0,41,2,0,0
JacksonDatabind/53,src_main_java_com_fasterxml_jackson_databind_type_TypeFactory,389,86,498,109,0,1,90,4,0,0,497,108,0,2,90,4,0,0
JacksonDatabind/54,src_main_java_com_fasterxml_jackson_databind_ser_PropertyBuilder,73,13,137,64,0,0,15,2,0,0,137,64,0,0,15,2,0,0
JacksonDatabind/55,src_main_java_com_fasterxml_jackson_databind_ser_std_StdKeySerializers,72,23,82,10,0,0,25,2,0,0,80,8,0,2,25,2,0,0
JacksonDatabind/56,src_main_java_com_fasterxml_jackson_databind_deser_std_FromStringDeserializer,107,23,165,58,0,0,26,3,0,0,164,57,0,1,26,3,0,0
JacksonDatabind/57,src_main_java_com_fasterxml_jackson_databind_ObjectReader,591,133,596,5,0,0,135,2,0,0,596,5,0,0,135,2,0,0
JacksonDatabind/58,src_main_java_com_fasterxml_jackson_databind_deser_BeanDeserializerFactory,361,23,392,31,0,0,25,2,0,0,392,31,0,0,25,2,0,0
JacksonDatabind/59,src_main_java_com_fasterxml_jackson_databind_JavaType,95,61,95,0,0,0,62,1,0,0,95,0,0,0,62,1,0,0
JacksonDatabind/59,src_main_java_com_fasterxml_jackson_databind_type_CollectionLikeType,86,27,86,0,0,0,28,1,0,0,86,0,0,0,28,1,0,0
JacksonDatabind/59,src_main_java_com_fasterxml_jackson_databind_type_MapLikeType,100,31,100,0,0,0,32,1,0,0,100,0,0,0,32,1,0,0
JacksonDatabind/59,src_main_java_com_fasterxml_jackson_databind_type_TypeFactory,482,90,533,51,0,0,92,2,0,0,533,51,0,0,92,2,0,0
JacksonDatabind/60,src_main_java_com_fasterxml_jackson_databind_ser_std_JsonValueSerializer,114,15,146,32,0,0,17,2,0,0,146,32,0,0,17,2,0,0
JacksonDatabind/61,src_main_java_com_fasterxml_jackson_databind_ObjectMapper,902,259,923,21,0,0,264,5,0,0,923,21,0,0,264,5,0,0
JacksonDatabind/61,src_main_java_com_fasterxml_jackson_databind_jsontype_impl_StdTypeResolverBuilder,52,17,95,43,0,0,20,3,0,0,95,43,0,0,20,3,0,0
JacksonDatabind/62,src_main_java_com_fasterxml_jackson_databind_deser_std_CollectionDeserializer,140,32,165,25,0,0,34,2,0,0,165,25,0,0,34,2,0,0
JacksonDatabind/63,src_main_java_com_fasterxml_jackson_databind_JsonMappingException,146,52,170,24,2,0,55,3,0,0,169,23,3,1,55,3,0,0
JacksonDatabind/65,src_main_java_com_fasterxml_jackson_databind_deser_std_StdKeyDeserializer,218,60,234,16,0,0,62,2,0,0,234,16,0,0,62,2,0,0
JacksonDatabind/65,src_main_java_com_fasterxml_jackson_databind_introspect_BasicBeanDescription,278,47,311,33,0,0,50,3,0,0,310,32,1,1,50,3,0,0
JacksonDatabind/66,src_main_java_com_fasterxml_jackson_databind_deser_std_StdKeyDeserializer,217,53,234,17,0,0,62,9,0,0,234,17,0,0,62,9,0,0
JacksonDatabind/67,src_main_java_com_fasterxml_jackson_databind_deser_BasicDeserializerFactory,1006,67,1045,39,0,0,69,2,0,0,1031,25,0,14,69,2,0,0
JacksonDatabind/69,src_main_java_com_fasterxml_jackson_databind_deser_impl_CreatorCollector,109,52,159,50,0,0,56,4,0,0,152,43,3,7,56,4,0,0
JacksonDatabind/7,src_main_java_com_fasterxml_jackson_databind_util_TokenBuffer,847,162,850,3,0,0,164,2,0,0,850,3,0,0,164,2,0,0
JacksonDatabind/70,src_main_java_com_fasterxml_jackson_databind_deser_impl_BeanPropertyMap,282,33,304,22,0,0,35,2,0,0,304,22,0,0,35,2,0,0
JacksonDatabind/71,src_main_java_com_fasterxml_jackson_databind_deser_std_StdKeyDeserializer,163,60,221,58,0,0,62,2,0,0,221,58,0,0,62,2,0,0
JacksonDatabind/72,src_main_java_com_fasterxml_jackson_databind_deser_impl_InnerClassProperty,63,20,63,0,0,0,21,1,0,0,63,0,0,0,21,1,0,0
JacksonDatabind/73,src_main_java_com_fasterxml_jackson_databind_introspect_POJOPropertiesCollector,584,54,590,6,0,0,56,2,0,0,590,6,0,0,56,2,0,0
JacksonDatabind/73,src_main_java_com_fasterxml_jackson_databind_introspect_POJOPropertyBuilder,624,112,653,29,0,0,114,2,0,0,653,29,0,0,114,2,0,0
JacksonDatabind/74,src_main_java_com_fasterxml_jackson_databind_jsontype_impl_AsPropertyTypeDeserializer,61,10,80,19,0,0,12,2,0,0,80,19,0,0,12,2,0,0
JacksonDatabind/75,src_main_java_com_fasterxml_jackson_databind_ser_std_EnumSerializer,58,10,88,30,0,0,14,4,0,0,88,30,0,0,14,4,0,0
JacksonDatabind/76,src_main_java_com_fasterxml_jackson_databind_deser_BuilderBasedDeserializer,380,27,418,38,0,0,29,2,0,0,418,38,0,0,29,2,0,0
JacksonDatabind/77,src_main_java_com_fasterxml_jackson_databind_deser_BeanDeserializerFactory,372,23,396,24,0,0,25,2,0,0,396,24,0,0,25,2,0,0
JacksonDatabind/78,src_main_java_com_fasterxml_jackson_databind_deser_BeanDeserializerFactory,392,23,416,24,0,0,25,2,0,0,416,24,0,0,25,2,0,0
JacksonDatabind/79,src_main_java_com_fasterxml_jackson_databind_introspect_JacksonAnnotationIntrospector,641,93,654,13,1,0,95,2,0,0,645,4,2,9,95,2,0,0
JacksonDatabind/79,src_main_java_com_fasterxml_jackson_databind_introspect_ObjectIdInfo,32,16,34,2,0,0,18,2,0,0,34,2,0,0,18,2,0,0
JacksonDatabind/79,src_main_java_com_fasterxml_jackson_databind_ser_std_BeanSerializerBase,349,35,446,97,0,0,37,2,0,0,446,97,0,0,37,2,0,0
JacksonDatabind/8,src_main_java_com_fasterxml_jackson_databind_deser_impl_CreatorCollector,127,49,145,18,0,0,51,2,0,0,144,17,1,1,51,2,0,0
JacksonDatabind/80,src_main_java_com_fasterxml_jackson_databind_jsontype_impl_StdSubtypeResolver,100,10,147,47,0,0,13,3,0,0,143,43,4,4,13,3,0,0
JacksonDatabind/81,src_main_java_com_fasterxml_jackson_databind_introspect_JacksonAnnotationIntrospector,624,94,741,117,0,0,97,3,0,0,732,108,0,9,97,3,0,0
JacksonDatabind/82,src_main_java_com_fasterxml_jackson_databind_deser_BeanDeserializerFactory,327,26,434,107,0,0,28,2,0,0,422,95,0,12,28,2,0,0
JacksonDatabind/83,src_main_java_com_fasterxml_jackson_databind_deser_std_FromStringDeserializer,135,26,177,42,0,0,28,2,0,0,177,42,0,0,28,2,0,0
JacksonDatabind/84,src_main_java_com_fasterxml_jackson_databind_type_ResolvedRecursiveType,48,18,48,0,0,0,19,1,0,0,48,0,0,0,19,1,0,0
JacksonDatabind/86,src_main_java_com_fasterxml_jackson_databind_type_ResolvedRecursiveType,48,18,48,0,0,0,19,1,0,0,48,0,0,0,19,1,0,0
JacksonDatabind/87,src_main_java_com_fasterxml_jackson_databind_util_StdDateFormat,166,43,275,109,0,0,47,4,0,0,264,98,0,11,47,4,0,0
JacksonDatabind/88,src_main_java_com_fasterxml_jackson_databind_jsontype_impl_ClassNameIdResolver,47,8,66,19,0,0,10,2,0,0,66,19,0,0,10,2,0,0
JacksonDatabind/89,src_main_java_com_fasterxml_jackson_databind_deser_BeanDeserializerFactory,422,27,435,13,0,0,28,1,0,0,422,0,0,13,28,1,0,0
JacksonDatabind/90,src_main_java_com_fasterxml_jackson_databind_deser_ValueInstantiator,86,36,88,2,0,0,38,2,0,0,88,2,0,0,38,2,0,0
JacksonDatabind/90,src_main_java_com_fasterxml_jackson_databind_deser_std_StdValueInstantiator,222,62,222,0,0,0,63,1,0,0,222,0,0,0,63,1,0,0
JacksonDatabind/91,src_main_java_com_fasterxml_jackson_databind_deser_DeserializerCache,225,22,233,8,0,0,24,2,0,0,231,6,0,2,24,2,0,0
JacksonDatabind/92,src_main_java_com_fasterxml_jackson_databind_deser_BeanDeserializerFactory,402,27,415,13,0,0,28,1,0,0,402,0,0,13,28,1,0,0
JacksonDatabind/93,src_main_java_com_fasterxml_jackson_databind_jsontype_impl_SubTypeValidator,3,6,42,39,0,0,8,2,0,0,22,19,0,20,8,2,0,0
JacksonDatabind/94,src_main_java_com_fasterxml_jackson_databind_jsontype_impl_SubTypeValidator,3,6,43,40,0,0,8,2,0,0,25,22,0,18,8,2,0,0
JacksonDatabind/95,src_main_java_com_fasterxml_jackson_databind_type_TypeFactory,525,91,575,50,2,2,94,3,0,0,575,50,2,2,94,3,0,0
JacksonDatabind/95,src_main_java_com_fasterxml_jackson_databind_type_TypeParser,58,18,73,15,0,0,20,2,0,0,73,15,0,0,20,2,0,0
JacksonDatabind/96,src_main_java_com_fasterxml_jackson_databind_deser_BasicDeserializerFactory,1108,69,1152,44,0,0,71,2,0,0,1138,30,0,14,71,2,0,0
JacksonDatabind/97,src_main_java_com_fasterxml_jackson_databind_node_POJONode,61,16,69,8,0,1,18,2,0,0,68,7,0,2,18,2,0,0
JacksonDatabind/98,src_main_java_com_fasterxml_jackson_databind_deser_impl_ExternalTypeHandler,212,36,250,38,0,0,38,2,0,0,250,38,0,0,38,2,0,0
JacksonDatabind/99,src_main_java_com_fasterxml_jackson_databind_type_ReferenceType,88,26,94,6,0,0,28,2,0,0,94,6,0,0,28,2,0,0
JacksonXml/1,src_main_java_com_fasterxml_jackson_dataformat_xml_deser_FromXmlParser,313,68,408,95,0,0,70,2,0,0,407,94,1,1,70,2,0,0
JacksonXml/2,src_main_java_com_fasterxml_jackson_dataformat_xml_deser_XmlTokenStream,207,44,239,32,0,0,46,2,0,0,238,31,0,1,46,2,0,0
JacksonXml/3,src_main_java_com_fasterxml_jackson_dataformat_xml_deser_FromXmlParser,341,68,415,74,0,0,70,2,0,0,415,74,0,0,70,2,0,0
JacksonXml/4,src_main_java_com_fasterxml_jackson_dataformat_xml_ser_XmlSerializerProvider,152,13,157,5,0,0,15,2,0,0,155,3,0,2,15,2,0,0
JacksonXml/5,src_main_java_com_fasterxml_jackson_dataformat_xml_ser_XmlSerializerProvider,125,15,128,3,0,0,17,2,0,0,127,2,0,1,17,2,0,0
JacksonXml/6,src_main_java_com_fasterxml_jackson_dataformat_xml_ser_ToXmlGenerator,648,84,648,0,0,0,85,1,0,0,648,0,0,0,85,1,0,0
Jsoup/1,src_main_java_org_jsoup_nodes_Document,44,11,58,14,0,0,13,2,0,0,56,12,2,2,13,2,0,0
Jsoup/10,src_main_java_org_jsoup_nodes_Node,165,52,185,20,0,0,54,2,0,0,185,20,0,0,54,2,0,0
Jsoup/11,src_main_java_org_jsoup_select_Selector,184,31,253,69,0,0,34,3,0,0,253,69,0,0,34,3,0,0
Jsoup/12,src_main_java_org_jsoup_select_Selector,263,34,278,15,0,0,36,2,0,0,277,14,0,1,36,2,0,0
Jsoup/13,src_main_java_org_jsoup_nodes_Node,230,59,233,3,0,0,61,2,0,0,233,3,0,0,61,2,0,0
Jsoup/14,src_main_java_org_jsoup_parser_Tokeniser,136,39,136,0,0,0,40,1,0,0,136,0,0,0,40,1,0,0
Jsoup/14,src_main_java_org_jsoup_parser_TokeniserState,1437,72,1445,8,0,0,74,2,0,0,1437,0,0,8,73,1,0,1
Jsoup/15,src_main_java_org_jsoup_parser_TreeBuilderState,898,41,1406,508,0,0,43,2,0,0,898,0,0,508,42,1,0,1
Jsoup/16,src_main_java_org_jsoup_nodes_DocumentType,3,2,15,12,0,0,5,3,0,0,14,11,0,1,5,3,0,0
Jsoup/17,src_main_java_org_jsoup_parser_TreeBuilderState,1406,41,1406,0,0,0,43,2,0,0,1406,0,0,0,43,2,0,0
Jsoup/18,src_main_java_org_jsoup_parser_CharacterReader,122,30,130,8,0,0,33,3,0,0,130,8,0,0,33,3,0,0
Jsoup/19,src_main_java_org_jsoup_safety_Whitelist,152,37,163,11,0,0,39,2,0,0,163,11,0,0,39,2,0,0
Jsoup/2,src_main_java_org_jsoup_parser_Parser,159,26,198,39,0,0,28,2,0,0,198,39,0,0,28,2,0,0
Jsoup/20,src_main_java_org_jsoup_helper_DataUtil,37,9,62,25,0,0,11,2,0,0,62,25,0,0,11,2,0,0
Jsoup/23,src_main_java_org_jsoup_parser_CharacterReader,131,32,131,0,0,0,33,1,0,0,131,0,0,0,33,1,0,0
Jsoup/23,src_main_java_org_jsoup_parser_Tokeniser,80,36,136,56,0,0,38,2,0,0,136,56,0,0,38,2,0,0
Jsoup/24,src_main_java_org_jsoup_parser_TokeniserState,1415,75,1445,30,0,0,77,2,0,0,1415,0,0,30,76,1,0,1
Jsoup/25,src_main_java_org_jsoup_parser_Tag,80,31,109,29,0,0,33,2,0,0,80,0,0,29,33,2,0,0
Jsoup/26,src_main_java_org_jsoup_safety_Cleaner,49,9,54,5,0,0,11,2,0,0,54,5,0,0,11,2,0,0
Jsoup/27,src_main_java_org_jsoup_helper_DataUtil,56,9,66,10,0,0,11,2,0,0,66,10,0,0,11,2,0,0
Jsoup/28,src_main_java_org_jsoup_nodes_Entities,54,20,66,12,0,0,22,2,0,0,55,1,0,11,22,2,0,0
Jsoup/28,src_main_java_org_jsoup_parser_Parser,39,17,39,0,0,0,18,1,0,0,39,0,0,0,18,1,0,0
Jsoup/28,src_main_java_org_jsoup_parser_Tokeniser,82,36,129,47,0,1,38,2,0,0,129,47,0,1,38,2,0,0
Jsoup/29,src_main_java_org_jsoup_nodes_Document,139,39,142,3,0,0,41,2,0,0,142,3,0,0,41,2,0,0
Jsoup/3,src_main_java_org_jsoup_nodes_Element,281,65,317,36,0,0,69,4,0,0,317,36,0,0,69,4,0,0
Jsoup/3,src_main_java_org_jsoup_parser_Parser,146,24,199,53,0,0,28,4,0,0,199,53,0,0,28,4,0,0
Jsoup/3,src_main_java_org_jsoup_parser_Tag,104,32,218,114,0,0,35,3,0,0,125,21,1,93,34,2,1,1
Jsoup/31,src_main_java_org_jsoup_parser_Token,112,63,112,0,0,0,65,2,0,0,112,0,0,0,65,2,0,0
Jsoup/31,src_main_java_org_jsoup_parser_TokeniserState,1462,75,1468,6,0,0,77,2,0,0,1462,0,0,6,76,1,0,1
Jsoup/31,src_main_java_org_jsoup_parser_XmlTreeBuilder,68,7,72,4,0,0,9,2,0,0,72,4,0,0,9,2,0,0
Jsoup/33,src_main_java_org_jsoup_parser_HtmlTreeBuilder,455,85,465,10,0,0,87,2,0,0,465,10,0,0,87,2,0,0
Jsoup/34,src_main_java_org_jsoup_parser_CharacterReader,165,34,181,16,0,0,36,2,0,0,181,16,0,0,36,2,0,0
Jsoup/35,src_main_java_org_jsoup_parser_HtmlTreeBuilderState,899,41,1406,507,0,0,43,2,0,0,899,0,0,507,42,1,0,1
Jsoup/36,src_main_java_org_jsoup_helper_DataUtil,41,8,86,45,0,0,12,4,0,0,86,45,0,0,12,4,0,0
Jsoup/37,src_main_java_org_jsoup_nodes_Element,397,92,401,4,0,0,94,2,0,0,401,4,0,0,94,2,0,0
Jsoup/38,src_main_java_org_jsoup_parser_HtmlTreeBuilderState,899,59,1407,508,0,0,61,2,0,0,899,0,0,508,60,1,0,1
Jsoup/39,src_main_java_org_jsoup_helper_DataUtil,61,10,107,46,0,0,12,2,0,0,107,46,0,0,12,2,0,0
Jsoup/4,src_main_java_org_jsoup_nodes_Entities,14,9,55,41,0,0,11,2,0,0,42,28,0,13,11,2,0,0
Jsoup/40,src_main_java_org_jsoup_nodes_DocumentType,12,3,17,5,0,0,5,2,0,0,17,5,0,0,5,2,0,0
Jsoup/41,src_main_java_org_jsoup_nodes_Element,414,92,423,9,0,0,94,2,0,0,422,8,0,1,94,2,0,0
Jsoup/42,src_main_java_org_jsoup_nodes_FormElement,15,6,47,32,0,0,8,2,0,0,47,32,0,0,8,2,0,0
Jsoup/43,src_main_java_org_jsoup_nodes_Element,416,93,425,9,0,0,95,2,0,0,424,8,0,1,95,2,0,0
Jsoup/44,src_main_java_org_jsoup_parser_TreeBuilder,26,15,34,8,0,0,19,4,0,0,34,8,0,0,19,4,0,0
Jsoup/45,src_main_java_org_jsoup_parser_HtmlTreeBuilder,393,97,451,58,0,0,99,2,0,0,451,58,0,0,99,2,0,0
Jsoup/46,src_main_java_org_jsoup_nodes_Entities,62,22,129,67,5,5,24,2,0,0,119,57,5,15,24,2,0,0
Jsoup/47,src_main_java_org_jsoup_nodes_Entities,62,22,131,69,3,3,24,2,0,0,119,57,4,15,24,2,0,0
Jsoup/48,src_main_java_org_jsoup_helper_HttpConnection,545,141,566,21,0,0,146,5,0,0,565,20,0,1,146,5,0,0
Jsoup/49,src_main_java_org_jsoup_nodes_Node,265,68,274,9,0,0,70,2,0,0,274,9,0,0,70,2,0,0
Jsoup/5,src_main_java_org_jsoup_parser_Parser,184,28,210,26,0,0,30,2,0,0,210,26,0,0,30,2,0,0
Jsoup/50,src_main_java_org_jsoup_helper_DataUtil,79,17,118,39,2,0,19,2,0,0,118,39,0,0,19,2,0,0
Jsoup/51,src_main_java_org_jsoup_parser_CharacterReader,248,42,253,5,0,0,44,2,0,0,253,5,0,0,44,2,0,0
Jsoup/52,src_main_java_org_jsoup_helper_DataUtil,100,19,140,40,0,0,21,2,0,0,139,39,1,1,21,2,0,0
Jsoup/52,src_main_java_org_jsoup_nodes_XmlDeclaration,12,7,15,3,0,0,10,3,0,0,15,3,0,0,10,3,0,0
Jsoup/52,src_main_java_org_jsoup_parser_XmlTreeBuilder,68,8,78,10,0,0,10,2,0,0,78,10,0,0,10,2,0,0
Jsoup/53,src_main_java_org_jsoup_parser_TokenQueue,148,34,171,23,0,0,36,2,0,0,171,23,0,0,36,2,0,0
Jsoup/54,src_main_java_org_jsoup_helper_W3CDom,83,13,88,5,0,0,16,3,0,0,88,5,0,0,16,3,0,0
Jsoup/55,src_main_java_org_jsoup_parser_TokeniserState,1364,81,1384,20,0,0,83,2,0,0,1364,0,0,20,82,1,0,1
Jsoup/56,src_main_java_org_jsoup_nodes_DocumentType,3,7,23,20,0,0,11,4,0,0,23,20,0,0,11,4,0,0
Jsoup/56,src_main_java_org_jsoup_parser_HtmlTreeBuilderState,1396,60,1415,19,0,0,62,2,0,0,1396,0,0,19,61,1,0,1
Jsoup/56,src_main_java_org_jsoup_parser_Token,168,79,174,6,0,0,82,3,0,0,174,6,0,0,82,3,0,0
Jsoup/56,src_main_java_org_jsoup_parser_TokeniserState,1356,81,1385,29,0,0,83,2,0,0,1356,0,0,29,82,1,0,1
Jsoup/56,src_main_java_org_jsoup_parser_XmlTreeBuilder,82,10,85,3,0,0,12,2,0,0,85,3,0,0,12,2,0,0
Jsoup/57,src_main_java_org_jsoup_nodes_Attributes,139,35,147,8,0,1,37,2,0,0,147,8,0,1,37,2,0,0
Jsoup/58,src_main_java_org_jsoup_Jsoup,38,15,40,2,0,0,17,2,0,0,39,1,0,1,17,2,0,0
Jsoup/58,src_main_java_org_jsoup_parser_Parser,53,22,53,0,0,0,23,1,0,0,53,0,0,0,23,1,0,0
Jsoup/58,src_main_java_org_jsoup_safety_Cleaner,64,16,69,5,0,0,18,2,0,0,69,5,0,0,18,2,0,0
Jsoup/59,src_main_java_org_jsoup_parser_Token,160,81,178,18,0,0,84,3,0,0,178,18,0,0,84,3,0,0
Jsoup/6,src_main_java_org_jsoup_nodes_Entities,14,9,55,41,0,0,11,2,0,0,42,28,0,13,11,2,0,0
Jsoup/60,src_main_java_org_jsoup_parser_TokenQueue,148,34,177,29,0,0,36,2,0,0,177,29,0,0,36,2,0,0
Jsoup/60,src_main_java_org_jsoup_select_QueryParser,249,27,252,3,0,0,29,2,0,0,252,3,0,0,29,2,0,0
Jsoup/61,src_main_java_org_jsoup_nodes_Element,429,96,460,31,0,0,98,2,0,0,460,31,0,0,98,2,0,0
Jsoup/62,src_main_java_org_jsoup_parser_HtmlTreeBuilderState,1396,60,1415,19,0,0,62,2,0,0,1396,0,0,19,61,1,0,1
Jsoup/64,src_main_java_org_jsoup_parser_HtmlTreeBuilderState,1409,60,1414,5,0,0,62,2,0,0,1414,5,0,0,62,2,0,0
Jsoup/65,src_main_java_org_jsoup_parser_HtmlTreeBuilder,457,96,461,4,0,0,99,3,0,0,461,4,0,0,99,3,0,0
Jsoup/65,src_main_java_org_jsoup_parser_HtmlTreeBuilderState,1317,57,1415,98,0,0,62,5,0,0,1317,0,0,98,58,1,0,4
Jsoup/66,src_main_java_org_jsoup_nodes_Element,498,112,514,16,0,0,118,6,0,0,513,15,0,1,118,6,0,0
Jsoup/67,src_main_java_org_jsoup_parser_HtmlTreeBuilder,448,97,462,14,0,0,99,2,0,0,462,14,0,0,99,2,0,0
Jsoup/68,src_main_java_org_jsoup_parser_HtmlTreeBuilder,448,98,461,13,0,0,100,2,0,0,461,13,0,0,100,2,0,0
Jsoup/69,src_main_java_org_jsoup_nodes_FormElement,46,6,46,0,0,0,7,1,0,0,46,0,0,0,7,1,0,0
Jsoup/7,src_main_java_org_jsoup_nodes_Document,88,31,100,12,0,0,33,2,0,0,100,12,0,0,33,2,0,0
Jsoup/70,src_main_java_org_jsoup_nodes_Element,515,118,522,7,0,0,120,2,0,0,522,7,0,0,120,2,0,0
Jsoup/71,src_main_java_org_jsoup_select_Evaluator,251,153,251,0,0,0,154,1,0,0,251,0,0,0,154,1,0,0
Jsoup/71,src_main_java_org_jsoup_select_QueryParser,200,27,256,56,0,0,29,2,0,0,256,56,0,0,29,2,0,0
Jsoup/72,src_main_java_org_jsoup_parser_CharacterReader,267,50,289,22,0,0,52,2,0,0,289,22,0,0,52,2,0,0
Jsoup/73,src_main_java_org_jsoup_helper_W3CDom,35,9,88,53,0,0,16,7,0,0,88,53,0,0,15,6,0,1
Jsoup/74,src_main_java_org_jsoup_helper_StringUtil,91,18,109,18,0,0,20,2,0,0,109,18,0,0,20,2,0,0
Jsoup/75,src_main_java_org_jsoup_nodes_Attributes,186,56,198,12,0,0,58,2,0,0,197,11,0,1,58,2,0,0
Jsoup/76,src_main_java_org_jsoup_parser_HtmlTreeBuilderState,909,60,1421,512,0,0,62,2,0,0,909,0,0,512,61,1,0,1
Jsoup/77,src_main_java_org_jsoup_parser_XmlTreeBuilder,69,11,87,18,0,0,13,2,0,0,87,18,0,0,13,2,0,0
Jsoup/78,src_main_java_org_jsoup_helper_DataUtil,83,23,137,54,0,0,25,2,0,0,137,54,0,0,25,2,0,0
Jsoup/79,src_main_java_org_jsoup_nodes_LeafNode,45,14,46,1,0,0,16,2,0,0,46,1,0,0,16,2,0,0
Jsoup/8,src_main_java_org_jsoup_nodes_Node,164,49,166,2,0,0,51,2,0,0,166,2,0,0,51,2,0,0
Jsoup/80,src_main_java_org_jsoup_parser_XmlTreeBuilder,74,11,87,13,0,0,13,2,0,0,87,13,0,0,13,2,0,0
Jsoup/81,src_main_java_org_jsoup_helper_DataUtil,83,23,146,63,0,0,25,2,0,0,146,63,0,0,25,2,0,0
Jsoup/82,src_main_java_org_jsoup_helper_DataUtil,70,21,139,69,0,0,23,2,0,0,139,69,0,0,23,2,0,0
Jsoup/84,src_main_java_org_jsoup_helper_W3CDom,60,13,92,32,0,0,16,3,0,0,92,32,0,0,16,3,0,0
Jsoup/86,src_main_java_org_jsoup_nodes_Comment,18,9,28,10,0,0,11,2,0,0,28,10,0,0,11,2,0,0
Jsoup/87,src_main_java_org_jsoup_nodes_Element,554,123,554,0,0,0,124,1,0,0,554,0,0,0,124,1,0,0
Jsoup/87,src_main_java_org_jsoup_parser_HtmlTreeBuilder,297,84,462,165,0,0,98,14,0,0,462,165,0,0,98,14,0,0
Jsoup/87,src_main_java_org_jsoup_parser_HtmlTreeBuilderState,490,54,1416,926,0,1,66,12,0,0,490,0,0,927,55,1,0,11
Jsoup/87,src_main_java_org_jsoup_parser_Tag,82,37,121,39,0,0,39,2,0,0,84,2,0,37,39,2,0,0
Jsoup/88,src_main_java_org_jsoup_nodes_Attribute,83,23,85,2,0,0,25,2,0,0,85,2,0,0,25,2,0,0
Jsoup/89,src_main_java_org_jsoup_nodes_Attribute,76,23,85,9,0,0,25,2,0,0,84,8,0,1,25,2,0,0
Jsoup/9,src_main_java_org_jsoup_nodes_Entities,46,14,64,18,0,0,16,2,0,0,46,0,0,18,16,2,0,0
Jsoup/90,src_main_java_org_jsoup_helper_HttpConnection,698,171,729,31,0,0,174,3,0,0,729,31,0,0,174,3,0,0
Jsoup/91,src_main_java_org_jsoup_UncheckedIOException,4,2,4,0,0,0,3,1,0,0,4,0,0,0,3,1,0,0
Jsoup/91,src_main_java_org_jsoup_parser_CharacterReader,318,50,326,8,0,0,53,3,0,0,326,8,0,0,53,3,0,0
Jsoup/92,src_main_java_org_jsoup_nodes_Attributes,193,55,198,5,0,0,58,3,0,0,198,5,0,0,58,3,0,0
Jsoup/92,src_main_java_org_jsoup_parser_HtmlTreeBuilder,451,96,462,11,0,0,98,2,0,0,462,11,0,0,98,2,0,0
Jsoup/92,src_main_java_org_jsoup_parser_ParseSettings,20,9,23,3,0,0,10,1,0,0,20,0,0,3,10,1,0,0
Jsoup/92,src_main_java_org_jsoup_parser_Token,167,85,187,20,0,0,88,3,0,0,187,20,0,0,88,3,0,0
Jsoup/92,src_main_java_org_jsoup_parser_XmlTreeBuilder,74,12,85,11,0,0,14,2,0,0,85,11,0,0,14,2,0,0
Jsoup/93,src_main_java_org_jsoup_nodes_FormElement,15,6,49,34,0,0,8,2,0,0,49,34,0,0,8,2,0,0
JxPath/1,src_java_org_apache_commons_jxpath_ri_model_dom_DOMNodePointer,472,49,514,42,0,0,51,2,0,0,514,42,0,0,51,2,0,0
JxPath/1,src_java_org_apache_commons_jxpath_ri_model_jdom_JDOMNodePointer,483,45,523,40,0,1,47,2,0,0,523,40,0,1,47,2,0,0
JxPath/10,src_java_org_apache_commons_jxpath_ri_compiler_CoreOperationRelationalExpression,60,8,62,2,0,0,10,2,0,0,62,2,0,0,10,2,0,0
JxPath/11,src_java_org_apache_commons_jxpath_ri_model_dom_DOMAttributeIterator,68,10,89,21,0,0,12,2,0,0,88,20,0,1,12,2,0,0
JxPath/11,src_java_org_apache_commons_jxpath_ri_model_jdom_JDOMAttributeIterator,20,6,59,39,0,0,8,2,0,0,57,37,2,2,8,2,0,0
JxPath/12,src_java_org_apache_commons_jxpath_ri_model_dom_DOMNodePointer,438,50,481,43,0,0,52,2,0,0,481,43,0,0,52,2,0,0
JxPath/14,src_java_org_apache_commons_jxpath_ri_compiler_CoreFunction,528,42,540,12,0,0,46,4,0,0,540,12,0,0,46,4,0,0
JxPath/15,src_java_org_apache_commons_jxpath_ri_axes_UnionContext,5,4,24,19,0,0,6,2,0,0,24,19,0,0,6,2,0,0
JxPath/16,src_java_org_apache_commons_jxpath_ri_model_dom_DOMNodePointer,463,52,505,42,0,1,54,2,0,0,505,42,0,1,54,2,0,0
JxPath/16,src_java_org_apache_commons_jxpath_ri_model_jdom_JDOMNodePointer,484,48,523,39,0,1,50,2,0,0,523,39,0,1,50,2,0,0
JxPath/18,src_java_org_apache_commons_jxpath_ri_axes_AttributeContext,19,8,36,17,0,0,10,2,0,0,34,15,1,2,10,2,0,0
JxPath/19,src_java_org_apache_commons_jxpath_ri_model_dom_DOMNodePointer,462,50,472,10,0,0,52,2,0,0,470,8,2,2,52,2,0,0
JxPath/19,src_java_org_apache_commons_jxpath_ri_model_jdom_JDOMNodePointer,486,46,507,21,0,0,48,2,0,0,507,21,0,0,48,2,0,0
JxPath/2,src_java_org_apache_commons_jxpath_ri_compiler_Expression,29,23,44,15,0,0,26,3,0,0,44,15,0,0,26,3,0,0
JxPath/20,src_java_org_apache_commons_jxpath_ri_compiler_CoreOperationRelationalExpression,35,8,62,27,0,0,10,2,0,0,61,26,0,1,10,2,0,0
JxPath/21,src_java_org_apache_commons_jxpath_ri_model_beans_PropertyPointer,85,27,87,2,0,0,29,2,0,0,86,1,0,1,29,2,0,0
JxPath/22,src_java_org_apache_commons_jxpath_ri_model_dom_DOMNodePointer,455,51,475,20,0,0,53,2,0,0,474,19,1,1,53,2,0,0
JxPath/3,src_java_org_apache_commons_jxpath_ri_model_beans_NullPropertyPointer,75,24,99,24,0,0,27,3,0,0,99,24,0,0,27,3,0,0
JxPath/5,src_java_org_apache_commons_jxpath_ri_model_NodePointer,220,64,242,22,0,0,66,2,0,0,241,21,0,1,66,2,0,0
JxPath/6,src_java_org_apache_commons_jxpath_ri_compiler_CoreOperationCompare,46,4,71,25,0,0,6,2,0,0,71,25,0,0,6,2,0,0
JxPath/7,src_java_org_apache_commons_jxpath_ri_compiler_CoreOperationGreaterThan,4,2,4,0,0,0,3,1,0,0,4,0,0,0,3,1,0,0
JxPath/7,src_java_org_apache_commons_jxpath_ri_compiler_CoreOperationGreaterThanOrEqual,4,2,4,0,0,0,3,1,0,0,4,0,0,0,3,1,0,0
JxPath/7,src_java_org_apache_commons_jxpath_ri_compiler_CoreOperationLessThan,4,2,4,0,0,0,3,1,0,0,4,0,0,0,3,1,0,0
JxPath/7,src_java_org_apache_commons_jxpath_ri_compiler_CoreOperationLessThanOrEqual,4,2,4,0,0,0,3,1,0,0,4,0,0,0,3,1,0,0
JxPath/7,src_java_org_apache_commons_jxpath_ri_compiler_CoreOperationRelationalExpression,6,3,6,0,0,0,4,1,0,0,6,0,0,0,4,1,0,0
JxPath/8,src_java_org_apache_commons_jxpath_ri_compiler_CoreOperationRelationalExpression,35,8,56,21,0,0,10,2,0,0,56,21,0,0,10,2,0,0
Lang/1,src_main_java_org_apache_commons_lang3_math_NumberUtils,422,65,556,134,0,0,67,2,0,0,556,134,0,0,67,2,0,0
Lang/10,src_main_java_org_apache_commons_lang3_time_FastDateParser,321,95,351,30,0,0,97,2,0,0,351,30,0,0,97,2,0,0
Lang/11,src_main_java_org_apache_commons_lang3_RandomStringUtils,28,12,88,60,0,0,14,2,0,0,88,60,0,0,14,2,0,0
Lang/12,src_main_java_org_apache_commons_lang3_RandomStringUtils,28,12,81,53,0,0,14,2,0,0,80,52,1,1,14,2,0,0
Lang/13,src_main_java_org_apache_commons_lang3_SerializationUtils,74,7,84,10,0,0,11,4,0,0,83,9,0,1,11,4,0,0
Lang/14,src_main_java_org_apache_commons_lang3_StringUtils,1887,177,1895,8,0,0,179,2,0,0,1895,8,0,0,179,2,0,0
Lang/15,src_main_java_org_apache_commons_lang3_reflect_TypeUtils,379,26,419,40,0,2,29,3,0,0,419,40,0,2,29,3,0,0
Lang/16,src_main_java_org_apache_commons_lang3_math_NumberUtils,452,64,570,118,0,0,66,2,0,0,570,118,0,0,66,2,0,0
Lang/17,src_main_java_org_apache_commons_lang3_text_translate_CharSequenceTranslator,18,4,37,19,0,0,6,2,0,0,35,17,1,2,6,2,0,0
Lang/18,src_main_java_org_apache_commons_lang3_time_FastDateFormat,356,143,470,114,0,0,145,2,0,0,465,109,4,5,145,2,0,0
Lang/19,src_main_java_org_apache_commons_lang3_text_translate_NumericEntityUnescaper,0,0,35,35,0,0,2,2,0,0,33,33,0,2,2,2,0,0
Lang/20,src_main_java_org_apache_commons_lang3_StringUtils,1836,174,1898,62,0,2,177,3,0,0,1873,37,0,27,177,3,0,0
Lang/21,src_main_java_org_apache_commons_lang3_time_DateUtils,468,79,473,5,0,0,81,2,0,0,473,5,0,0,81,2,0,0
Lang/22,src_main_java_org_apache_commons_lang3_math_Fraction,330,51,362,32,0,0,53,2,0,0,362,32,0,0,53,2,0,0
Lang/23,src_main_java_org_apache_commons_lang3_text_ExtendedMessageFormat,219,28,219,0,0,0,29,1,0,0,219,0,0,0,29,1,0,0
Lang/24,src_main_java_org_apache_commons_lang3_math_NumberUtils,491,64,572,81,0,0,66,2,0,0,572,81,0,0,66,2,0,0
Lang/26,src_main_java_org_apache_commons_lang3_time_FastDateFormat,601,160,605,4,0,0,162,2,0,0,605,4,0,0,162,2,0,0
Lang/27,src_main_java_org_apache_commons_lang3_math_NumberUtils,454,64,569,115,0,0,66,2,0,0,566,112,3,3,66,2,0,0
Lang/28,src_main_java_org_apache_commons_lang3_text_translate_NumericEntityUnescaper,0,0,27,27,0,0,2,2,0,0,27,27,0,0,2,2,0,0
Lang/29,src_main_java_org_apache_commons_lang3_SystemUtils,110,100,112,2,0,0,102,2,0,0,112,2,0,0,102,2,0,0
Lang/3,src_main_java_org_apache_commons_lang3_math_NumberUtils,422,65,552,130,0,0,67,2,0,0,550,128,2,2,67,2,0,0
Lang/30,src_main_java_org_apache_commons_lang3_StringUtils,1666,155,1753,87,0,0,162,7,0,0,1750,84,1,3,162,7,0,0
Lang/31,src_main_java_org_apache_commons_lang3_StringUtils,1724,160,1739,15,0,0,162,2,0,0,1739,15,0,0,162,2,0,0
Lang/32,src_main_java_org_apache_commons_lang3_builder_HashCodeBuilder,214,35,220,6,0,0,40,5,0,0,220,6,0,0,40,5,0,0
Lang/33,src_main_java_org_apache_commons_lang3_ClassUtils,344,43,382,38,0,0,45,2,0,0,356,12,0,26,45,2,0,0
Lang/34,src_main_java_org_apache_commons_lang3_builder_ToStringStyle,640,156,645,5,0,0,159,3,0,0,645,5,0,0,159,3,0,0
Lang/35,src_main_java_org_apache_commons_lang3_ArrayUtils,1396,193,1419,23,0,0,196,3,0,0,1417,21,0,2,196,3,0,0
Lang/36,src_java_org_apache_commons_lang3_math_NumberUtils,373,63,563,190,0,0,66,3,0,0,563,190,0,0,66,3,0,0
Lang/37,src_java_org_apache_commons_lang3_ArrayUtils,1389,193,1401,12,0,0,195,2,0,0,1401,12,0,0,195,2,0,0
Lang/38,src_java_org_apache_commons_lang3_time_FastDateFormat,598,160,604,6,0,0,162,2,0,0,604,6,0,0,162,2,0,0
Lang/39,src_java_org_apache_commons_lang3_StringUtils,1585,153,1661,76,0,0,155,2,0,0,1661,76,0,0,155,2,0,0
Lang/4,src_main_java_org_apache_commons_lang3_text_translate_LookupTranslator,0,2,32,32,0,0,6,4,0,0,32,32,0,0,6,4,0,0
Lang/40,src_java_org_apache_commons_lang_StringUtils,1618,152,1622,4,0,0,154,2,0,0,1622,4,0,0,154,2,0,0
Lang/41,src_java_org_apache_commons_lang_ClassUtils,314,42,363,49,0,0,45,3,0,0,336,22,0,27,45,3,0,0
Lang/43,src_java_org_apache_commons_lang_text_ExtendedMessageFormat,196,27,218,22,0,0,29,2,0,0,218,22,0,0,29,2,0,0
Lang/44,src_java_org_apache_commons_lang_NumberUtils,185,18,300,115,0,0,20,2,0,0,300,115,0,0,20,2,0,0
Lang/45,src_java_org_apache_commons_lang_WordUtils,169,13,198,29,0,0,15,2,0,0,198,29,0,0,15,2,0,0
Lang/46,src_java_org_apache_commons_lang_StringEscapeUtils,221,23,315,94,0,0,30,7,0,0,315,94,0,0,30,7,0,0
Lang/47,src_java_org_apache_commons_lang_text_StrBuilder,987,161,1021,34,0,0,164,3,0,0,1021,34,0,0,164,3,0,0
Lang/48,src_java_org_apache_commons_lang_builder_EqualsBuilder,287,29,332,45,0,0,31,2,0,0,332,45,0,0,31,2,0,0
Lang/49,src_java_org_apache_commons_lang_math_Fraction,354,51,360,6,0,0,53,2,0,0,360,6,0,0,53,2,0,0
Lang/50,src_java_org_apache_commons_lang_time_FastDateFormat,562,160,604,42,0,0,163,3,0,0,600,38,2,4,163,3,0,0
Lang/51,src_java_org_apache_commons_lang_BooleanUtils,231,36,263,32,0,0,38,2,0,0,263,32,0,0,38,2,0,0
Lang/52,src_java_org_apache_commons_lang_StringEscapeUtils,184,20,254,70,0,0,22,2,0,0,253,69,1,1,22,2,0,0
Lang/53,src_java_org_apache_commons_lang_time_DateUtils,225,49,310,85,0,0,51,2,0,0,310,85,0,0,51,2,0,0
Lang/54,src_java_org_apache_commons_lang_LocaleUtils,69,12,105,36,0,0,14,2,0,0,102,33,0,3,14,2,0,0
Lang/55,src_java_org_apache_commons_lang_time_StopWatch,62,21,68,6,0,0,23,2,0,0,68,6,0,0,23,2,0,0
Lang/56,src_java_org_apache_commons_lang_time_FastDateFormat,605,159,605,0,0,0,162,3,0,0,605,0,0,0,162,3,0,0
Lang/57,src_java_org_apache_commons_lang_LocaleUtils,100,12,105,5,0,0,14,2,0,0,102,2,0,3,14,2,0,0
Lang/58,src_java_org_apache_commons_lang_math_NumberUtils,548,70,663,115,0,0,72,2,0,0,663,115,0,0,72,2,0,0
Lang/59,src_java_org_apache_commons_lang_text_StrBuilder,932,140,947,15,2,2,142,2,0,0,945,13,4,4,142,2,0,0
Lang/6,src_main_java_org_apache_commons_lang3_text_translate_CharSequenceTranslator,18,4,39,21,0,0,6,2,0,0,39,21,0,0,6,2,0,0
Lang/60,src_java_org_apache_commons_lang_text_StrBuilder,929,139,949,20,0,0,142,3,0,0,949,20,0,0,142,3,0,0
Lang/61,src_java_org_apache_commons_lang_text_StrBuilder,922,140,949,27,0,0,142,2,0,0,948,26,0,1,142,2,0,0
Lang/63,src_java_org_apache_commons_lang_time_DurationFormatUtils,236,30,306,70,0,1,32,2,0,0,306,70,0,1,32,2,0,0
Lang/64,src_java_org_apache_commons_lang_enums_ValuedEnum,23,6,25,2,0,0,8,2,0,0,25,2,0,0,8,2,0,0
Lang/65,src_java_org_apache_commons_lang_time_DateUtils,225,49,280,55,0,0,51,2,0,0,280,55,0,0,51,2,0,0
Lang/7,src_main_java_org_apache_commons_lang3_math_NumberUtils,444,63,574,130,0,2,66,3,0,0,574,130,0,2,66,3,0,0
Lang/8,src_main_java_org_apache_commons_lang3_time_FastDatePrinter,420,122,431,11,0,0,126,4,0,0,431,11,0,0,126,4,0,0
Lang/9,src_main_java_org_apache_commons_lang3_time_FastDateParser,320,95,351,31,0,0,97,2,0,0,351,31,0,0,97,2,0,0
Math/1,src_main_java_org_apache_commons_math3_fraction_BigFraction,252,71,303,51,0,0,73,2,0,0,303,51,0,0,73,2,0,0
Math/1,src_main_java_org_apache_commons_math3_fraction_Fraction,165,48,216,51,0,0,50,2,0,0,216,51,0,0,50,2,0,0
Math/10,src_main_java_org_apache_commons_math3_analysis_differentiation_DSCompiler,666,54,689,23,0,0,56,2,0,0,689,23,0,0,56,2,0,0
Math/100,src_java_org_apache_commons_math_estimation_AbstractEstimator,57,21,91,34,0,0,24,3,0,0,91,34,0,0,24,3,0,0
Math/101,src_java_org_apache_commons_math_complex_ComplexFormat,145,32,185,40,0,0,34,2,0,0,185,40,0,0,34,2,0,0
Math/102,src_java_org_apache_commons_math_stat_inference_ChiSquareTestImpl,142,18,156,14,0,0,20,2,0,0,155,13,1,1,20,2,0,0
Math/103,src_java_org_apache_commons_math_distribution_NormalDistributionImpl,52,13,54,2,0,0,15,2,0,0,54,2,0,0,15,2,0,0
Math/104,src_java_org_apache_commons_math_special_Gamma,67,12,67,0,0,0,14,2,0,0,67,0,0,0,14,2,0,0
Math/105,src_java_org_apache_commons_math_stat_regression_SimpleRegression,85,30,87,2,0,0,32,2,0,0,86,1,0,1,32,2,0,0
Math/106,src_java_org_apache_commons_math_fraction_ProperFractionFormat,30,8,69,39,0,0,10,2,0,0,69,39,0,0,10,2,0,0
Math/11,src_main_java_org_apache_commons_math3_distribution_MultivariateNormalDistribution,71,12,77,6,0,0,14,2,0,0,77,6,0,0,14,2,0,0
Math/12,src_main_java_org_apache_commons_math3_random_BitsStreamGenerator,62,15,62,0,0,0,16,1,0,0,62,0,0,0,16,1,0,0
Math/13,src_main_java_org_apache_commons_math3_optimization_general_AbstractLeastSquaresOptimizer,99,32,102,3,0,0,34,2,0,0,102,3,0,0,34,2,0,0
Math/14,src_main_java_org_apache_commons_math3_optim_nonlinear_vector_Weight,7,3,9,2,0,1,5,2,0,0,9,2,0,1,5,2,0,0
Math/14,src_main_java_org_apache_commons_math3_optim_nonlinear_vector_jacobian_AbstractLeastSquaresOptimizer,48,14,51,3,0,0,16,2,0,0,51,3,0,0,16,2,0,0
Math/15,src_main_java_org_apache_commons_math3_util_FastMath,1796,130,1916,120,0,0,132,2,0,0,1916,120,0,0,132,2,0,0
Math/16,src_main_java_org_apache_commons_math3_util_FastMath,1787,128,1896,109,0,0,131,3,0,0,1894,107,2,2,131,3,0,0
Math/17,src_main_java_org_apache_commons_math3_dfp_Dfp,1407,95,1409,2,0,0,97,2,0,0,1409,2,0,0,97,2,0,0
Math/18,src_main_java_org_apache_commons_math3_optimization_direct_CMAESOptimizer,579,108,610,31,0,2,113,5,0,0,608,29,0,4,113,5,0,0
Math/19,src_main_java_org_apache_commons_math3_optimization_direct_CMAESOptimizer,559,111,603,44,0,0,113,2,0,0,603,44,0,0,113,2,0,0
Math/2,src_main_java_org_apache_commons_math3_distribution_HypergeometricDistribution,96,23,98,2,0,0,25,2,0,0,97,1,0,1,25,2,0,0
Math/20,src_main_java_org_apache_commons_math3_optimization_direct_CMAESOptimizer,601,110,603,2,0,0,113,3,0,0,603,2,0,0,113,3,0,0
Math/21,src_main_java_org_apache_commons_math3_linear_RectangularCholeskyDecomposition,4,4,63,59,0,1,6,2,0,0,63,59,0,1,6,2,0,0
Math/22,src_main_java_org_apache_commons_math3_distribution_FDistribution,67,22,69,2,0,0,24,2,0,0,68,1,0,1,24,2,0,0
Math/22,src_main_java_org_apache_commons_math3_distribution_UniformRealDistribution,45,19,47,2,0,0,21,2,0,0,46,1,0,1,21,2,0,0
Math/23,src_main_java_org_apache_commons_math3_optimization_univariate_BrentOptimizer,24,7,155,131,0,0,9,2,0,0,155,131,0,0,9,2,0,0
Math/24,src_main_java_org_apache_commons_math3_optimization_univariate_BrentOptimizer,24,7,153,129,0,2,9,2,0,0,151,127,0,4,9,2,0,0
Math/25,src_main_java_org_apache_commons_math3_optimization_fitting_HarmonicFitter,52,11,107,55,0,0,14,3,0,0,107,55,0,0,14,3,0,0
Math/26,src_main_java_org_apache_commons_math3_fraction_Fraction,165,47,216,51,0,0,49,2,0,0,215,50,0,1,49,2,0,0
Math/27,src_main_java_org_apache_commons_math3_fraction_Fraction,214,47,215,1,0,1,49,2,0,0,215,1,0,1,49,2,0,0
Math/28,src_main_java_org_apache_commons_math3_optimization_linear_SimplexSolver,49,10,97,48,0,0,12,2,0,0,90,41,7,7,12,2,0,0
Math/29,src_main_java_org_apache_commons_math3_linear_OpenMapRealVector,387,66,402,15,0,0,69,3,0,0,402,15,0,0,69,3,0,0
Math/3,src_main_java_org_apache_commons_math3_util_MathArrays,524,47,565,41,0,0,49,2,0,0,565,41,0,0,49,2,0,0
Math/30,src_main_java_org_apache_commons_math3_stat_inference_MannWhitneyUTest,32,7,39,7,0,0,9,2,0,0,39,7,0,0,9,2,0,0
Math/31,src_main_java_org_apache_commons_math3_util_ContinuedFraction,8,7,37,29,7,5,9,2,0,0,37,29,0,5,9,2,0,0
Math/32,src_main_java_org_apache_commons_math3_geometry_euclidean_twod_PolygonsSet,155,24,196,41,0,0,26,2,0,0,196,41,0,0,26,2,0,0
Math/33,src_main_java_org_apache_commons_math3_optimization_linear_SimplexTableau,189,44,221,32,0,0,46,2,0,0,221,32,0,0,46,2,0,0
Math/34,src_main_java_org_apache_commons_math3_genetics_ListPopulation,60,14,62,2,0,0,16,2,0,0,62,2,0,0,16,2,0,0
Math/35,src_main_java_org_apache_commons_math3_genetics_ElitisticListPopulation,16,4,22,6,0,0,7,3,0,0,22,6,0,0,7,3,0,0
Math/36,src_main_java_org_apache_commons_math_fraction_BigFraction,286,70,292,6,0,0,73,3,0,0,292,6,0,0,73,3,0,0
Math/37,src_main_java_org_apache_commons_math_complex_Complex,272,52,288,16,0,0,55,3,0,0,288,16,0,0,55,3,0,0
Math/38,src_main_java_org_apache_commons_math_optimization_direct_BOBYQAOptimizer,1422,54,1559,137,0,0,56,2,0,0,1557,135,0,2,56,2,0,0
Math/39,src_main_java_org_apache_commons_math_ode_nonstiff_EmbeddedRungeKuttaIntegrator,34,19,122,88,0,0,21,2,0,0,122,88,0,0,21,2,0,0
Math/4,src_main_java_org_apache_commons_math3_geometry_euclidean_threed_SubLine,19,7,28,9,0,0,9,2,0,0,28,9,0,0,9,2,0,0
Math/4,src_main_java_org_apache_commons_math3_geometry_euclidean_twod_SubLine,48,8,59,11,0,0,10,2,0,0,59,11,0,0,10,2,0,0
Math/40,src_main_java_org_apache_commons_math_analysis_solvers_BracketingNthOrderBrentSolver,43,14,166,123,0,2,16,2,0,0,164,121,0,4,16,2,0,0
Math/41,src_main_java_org_apache_commons_math_stat_descriptive_moment_Variance,115,24,142,27,0,0,26,2,0,0,141,26,0,1,26,2,0,0
Math/42,src_main_java_org_apache_commons_math_optimization_linear_SimplexTableau,197,44,218,21,0,0,46,2,0,0,218,21,0,0,46,2,0,0
Math/43,src_main_java_org_apache_commons_math_stat_descriptive_SummaryStatistics,202,57,219,17,0,0,59,2,0,0,216,14,0,3,59,2,0,0
Math/44,src_main_java_org_apache_commons_math_ode_AbstractIntegrator,72,33,130,58,0,0,35,2,0,0,130,58,0,0,35,2,0,0
Math/45,src_main_java_org_apache_commons_math_linear_OpenMapRealMatrix,115,19,120,5,0,0,21,2,0,0,120,5,0,0,21,2,0,0
Math/46,src_main_java_org_apache_commons_math_complex_Complex,229,51,262,33,0,0,54,3,0,0,258,29,0,4,54,3,0,0
Math/47,src_main_java_org_apache_commons_math_complex_Complex,223,49,261,38,0,0,53,4,0,0,256,33,0,5,53,4,0,0
Math/48,src_main_java_org_apache_commons_math_analysis_solvers_BaseSecantSolver,19,10,103,84,0,0,12,2,0,0,97,78,6,6,12,2,0,0
Math/49,src_main_java_org_apache_commons_math_linear_OpenMapRealVector,440,75,476,36,0,0,80,5,0,0,472,32,0,4,80,5,0,0
Math/5,src_main_java_org_apache_commons_math3_complex_Complex,281,53,300,19,0,0,55,2,0,0,300,19,0,0,55,2,0,0
Math/50,src_main_java_org_apache_commons_math_analysis_solvers_BaseSecantSolver,19,10,103,84,0,0,12,2,0,0,97,78,6,6,12,2,0,0
Math/51,src_main_java_org_apache_commons_math_analysis_solvers_BaseSecantSolver,19,10,100,81,0,0,12,2,0,0,100,81,0,0,12,2,0,0
Math/52,src_main_java_org_apache_commons_math_geometry_euclidean_threed_Rotation,327,26,379,52,0,0,28,2,0,0,377,50,0,2,28,2,0,0
Math/53,src_main_java_org_apache_commons_math_complex_Complex,221,44,224,3,0,0,46,2,0,0,224,3,0,0,46,2,0,0
Math/54,src_main_java_org_apache_commons_math_dfp_Dfp,1258,86,1360,102,0,0,89,3,0,0,1359,101,0,1,89,3,0,0
Math/55,src_main_java_org_apache_commons_math_geometry_Vector3D,136,49,138,2,0,0,51,2,0,0,138,2,0,0,51,2,0,0
Math/56,src_main_java_org_apache_commons_math_util_MultidimensionalCounter,73,22,91,18,0,1,24,2,0,0,91,18,0,1,24,2,0,0
Math/57,src_main_java_org_apache_commons_math_stat_clustering_KMeansPlusPlusClusterer,116,11,141,25,0,0,13,2,0,0,141,25,0,0,13,2,0,0
Math/58,src_main_java_org_apache_commons_math_optimization_fitting_GaussianFitter,120,17,123,3,0,0,19,2,0,0,123,3,0,0,19,2,0,0
Math/59,src_main_java_org_apache_commons_math_util_FastMath,1842,90,1872,30,0,0,92,2,0,0,1843,1,0,29,92,2,0,0
Math/6,src_main_java_org_apache_commons_math3_optim_BaseOptimizer,34,17,38,4,0,0,19,2,0,0,38,4,0,0,19,2,0,0
Math/6,src_main_java_org_apache_commons_math3_optim_nonlinear_scalar_gradient_NonLinearConjugateGradientOptimizer,56,23,126,70,0,0,25,2,0,0,126,70,0,0,25,2,0,0
Math/6,src_main_java_org_apache_commons_math3_optim_nonlinear_scalar_noderiv_CMAESOptimizer,456,107,571,115,0,0,109,2,0,0,571,115,0,0,109,2,0,0
Math/6,src_main_java_org_apache_commons_math3_optim_nonlinear_scalar_noderiv_PowellOptimizer,48,17,121,73,0,0,19,2,0,0,121,73,0,0,19,2,0,0
Math/6,src_main_java_org_apache_commons_math3_optim_nonlinear_scalar_noderiv_SimplexOptimizer,27,8,51,24,0,0,10,2,0,0,51,24,0,0,10,2,0,0
Math/6,src_main_java_org_apache_commons_math3_optim_nonlinear_vector_jacobian_GaussNewtonOptimizer,9,4,68,59,0,0,6,2,0,0,68,59,0,0,6,2,0,0
Math/6,src_main_java_org_apache_commons_math3_optim_nonlinear_vector_jacobian_LevenbergMarquardtOptimizer,279,25,462,183,0,0,27,2,0,0,462,183,0,0,27,2,0,0
Math/60,src_main_java_org_apache_commons_math_distribution_NormalDistributionImpl,58,18,61,3,0,0,20,2,0,0,61,3,0,0,20,2,0,0
Math/61,src_main_java_org_apache_commons_math_distribution_PoissonDistributionImpl,35,17,42,7,0,1,19,2,0,0,41,6,0,2,19,2,0,0
Math/62,src_main_java_org_apache_commons_math_optimization_univariate_MultiStartUnivariateRealOptimizer,32,15,54,22,0,2,18,3,0,0,53,21,0,3,18,3,0,0
Math/63,src_main_java_org_apache_commons_math_util_MathUtils,740,81,741,1,0,1,83,2,0,0,741,1,0,1,83,2,0,0
Math/64,src_main_java_org_apache_commons_math_optimization_general_LevenbergMarquardtOptimizer,267,23,427,160,0,0,25,2,0,0,424,157,2,3,25,2,0,0
Math/65,src_main_java_org_apache_commons_math_optimization_general_AbstractLeastSquaresOptimizer,104,35,113,9,0,0,38,3,0,0,112,8,0,1,38,3,0,0
Math/66,src_main_java_org_apache_commons_math_optimization_univariate_BrentOptimizer,0,1,125,125,0,3,5,4,0,0,121,121,0,7,5,4,0,0
Math/67,src_main_java_org_apache_commons_math_optimization_MultiStartUnivariateRealOptimizer,109,28,113,4,0,0,31,3,0,0,111,2,0,2,31,3,0,0
Math/68,src_main_java_org_apache_commons_math_optimization_general_LevenbergMarquardtOptimizer,257,20,414,157,0,0,23,3,0,0,409,152,2,5,23,3,0,0
Math/69,src_main_java_org_apache_commons_math_stat_correlation_PearsonsCorrelation,75,14,90,15,0,1,16,2,0,0,90,15,0,1,16,2,0,0
Math/7,src_main_java_org_apache_commons_math3_ode_AbstractIntegrator,79,33,135,56,0,7,35,2,0,0,135,56,0,7,35,2,0,0
Math/70,src_main_java_org_apache_commons_math_analysis_solvers_BisectionSolver,32,5,34,2,0,0,7,2,0,0,34,2,0,0,7,2,0,0
Math/71,src_main_java_org_apache_commons_math_ode_nonstiff_EmbeddedRungeKuttaIntegrator,34,19,146,112,0,0,21,2,0,0,146,112,0,0,21,2,0,0
Math/71,src_main_java_org_apache_commons_math_ode_nonstiff_RungeKuttaIntegrator,7,6,88,81,0,0,8,2,0,0,88,81,0,0,8,2,0,0
Math/72,src_main_java_org_apache_commons_math_analysis_solvers_BrentSolver,110,8,138,28,0,0,10,2,0,0,136,26,0,2,10,2,0,0
Math/73,src_main_java_org_apache_commons_math_analysis_solvers_BrentSolver,110,8,135,25,0,0,10,2,0,0,135,25,0,0,10,2,0,0
Math/74,src_main_java_org_apache_commons_math_ode_nonstiff_EmbeddedRungeKuttaIntegrator,34,19,140,106,0,0,21,2,0,0,137,103,0,3,21,2,0,0
Math/75,src_main_java_org_apache_commons_math_stat_Frequency,174,38,176,2,0,0,40,2,0,0,176,2,0,0,40,2,0,0
Math/76,src_main_java_org_apache_commons_math_linear_SingularValueDecompositionImpl,99,35,159,60,0,2,38,3,0,0,153,54,2,8,38,3,0,0
Math/77,src_main_java_org_apache_commons_math_linear_ArrayRealVector,567,106,573,6,0,0,108,2,0,0,570,3,0,3,108,2,0,0
Math/77,src_main_java_org_apache_commons_math_linear_OpenMapRealVector,479,79,479,0,0,0,80,1,0,0,479,0,0,0,80,1,0,0
Math/78,src_main_java_org_apache_commons_math_ode_events_EventState,59,24,109,50,0,0,26,2,0,0,109,50,0,0,26,2,0,0
Math/79,src_main_java_org_apache_commons_math_util_MathUtils,603,72,610,7,0,0,74,2,0,0,610,7,0,0,74,2,0,0
Math/8,src_main_java_org_apache_commons_math3_distribution_DiscreteDistribution,41,9,49,8,0,1,11,2,0,0,49,8,0,1,11,2,0,0
Math/80,src_main_java_org_apache_commons_math_linear_EigenDecompositionImpl,1028,76,1042,14,0,0,78,2,0,0,1042,14,0,0,78,2,0,0
Math/81,src_main_java_org_apache_commons_math_linear_EigenDecompositionImpl,732,74,1041,309,0,0,78,4,0,0,1041,309,0,0,78,4,0,0
Math/82,src_main_java_org_apache_commons_math_optimization_linear_SimplexSolver,67,10,82,15,0,0,12,2,0,0,82,15,0,0,12,2,0,0
Math/83,src_main_java_org_apache_commons_math_optimization_linear_SimplexTableau,158,41,185,27,0,0,44,3,0,0,183,25,0,2,44,3,0,0
Math/84,src_main_java_org_apache_commons_math_optimization_direct_MultiDirectional,21,5,40,19,0,0,7,2,0,0,40,19,0,0,7,2,0,0
Math/85,src_java_org_apache_commons_math_analysis_solvers_UnivariateRealSolverUtils,18,8,44,26,0,0,10,2,0,0,44,26,0,0,10,2,0,0
Math/86,src_java_org_apache_commons_math_linear_CholeskyDecompositionImpl,114,19,150,36,0,0,21,2,0,0,149,35,0,1,21,2,0,0
Math/87,src_java_org_apache_commons_math_optimization_linear_SimplexTableau,167,39,178,11,0,0,41,2,0,0,175,8,2,3,41,2,0,0
Math/88,src_java_org_apache_commons_math_optimization_linear_SimplexTableau,164,39,175,11,0,0,41,2,0,0,174,10,1,1,41,2,0,0
Math/89,src_java_org_apache_commons_math_stat_Frequency,142,32,144,2,0,0,34,2,0,0,144,2,0,0,34,2,0,0
Math/9,src_main_java_org_apache_commons_math3_geometry_euclidean_threed_Line,57,18,59,2,0,1,20,2,0,0,59,2,0,1,20,2,0,0
Math/90,src_java_org_apache_commons_math_stat_Frequency,127,31,142,15,0,0,33,2,0,0,142,15,0,0,33,2,0,0
Math/91,src_java_org_apache_commons_math_fraction_Fraction,195,29,197,2,0,2,31,2,0,0,197,2,0,2,31,2,0,0
Math/92,src_java_org_apache_commons_math_util_MathUtils,336,50,373,37,0,0,54,4,0,0,373,37,0,0,54,4,0,0
Math/93,src_java_org_apache_commons_math_util_MathUtils,349,50,368,19,0,0,54,4,0,0,367,18,0,1,54,4,0,0
Math/94,src_java_org_apache_commons_math_util_MathUtils,337,51,369,32,0,0,53,2,0,0,368,31,0,1,53,2,0,0
Math/95,src_java_org_apache_commons_math_distribution_FDistributionImpl,40,12,45,5,0,0,14,2,0,0,44,4,0,1,14,2,0,0
Math/96,src_java_org_apache_commons_math_complex_Complex,173,36,193,20,0,0,38,2,0,0,191,18,0,2,38,2,0,0
Math/97,src_java_org_apache_commons_math_analysis_BrentSolver,101,4,114,13,0,0,6,2,0,0,114,13,0,0,6,2,0,0
Math/98,src_java_org_apache_commons_math_linear_BigMatrixImpl,658,70,673,15,0,0,72,2,0,0,673,15,0,0,72,2,0,0
Math/98,src_java_org_apache_commons_math_linear_RealMatrixImpl,549,52,565,16,0,0,54,2,0,0,565,16,0,0,54,2,0,0
Math/99,src_java_org_apache_commons_math_util_MathUtils,391,52,431,40,0,0,55,3,0,0,431,40,0,0,55,3,0,0
Mockito/1,src_org_mockito_internal_invocation_InvocationMatcher,68,17,79,11,0,0,19,2,0,0,75,7,4,4,19,2,0,0
Mockito/10,src_org_mockito_internal_stubbing_defaultanswers_ReturnsDeepStubs,29,19,43,14,0,0,23,4,0,0,43,14,1,0,23,4,0,0
Mockito/11,src_org_mockito_internal_creation_DelegatingMethod,17,9,21,4,0,0,12,3,0,0,20,3,0,1,12,3,0,0
Mockito/12,src_org_mockito_internal_util_reflection_GenericMaster,0,0,7,7,0,0,2,2,0,0,7,7,0,0,2,2,0,0
Mockito/13,src_org_mockito_internal_MockHandler,17,12,45,28,0,0,14,2,0,0,45,28,0,0,14,2,0,0
Mockito/14,src_org_mockito_internal_MockHandler,17,12,43,26,0,0,14,2,0,0,43,26,0,0,14,2,0,0
Mockito/14,src_org_mockito_internal_MockitoCore,75,16,84,9,0,0,18,2,0,0,84,9,0,0,18,2,0,0
Mockito/15,src_org_mockito_internal_configuration_injection_FinalMockCandidateFilter,2,1,15,13,0,0,4,3,0,0,14,12,0,1,3,2,0,1
Mockito/16,src_org_mockito_Mockito,54,32,58,4,0,0,35,3,0,0,58,4,0,0,35,3,0,0
Mockito/16,src_org_mockito_internal_MockitoCore,73,15,77,4,0,0,17,2,0,0,77,4,0,0,17,2,0,0
Mockito/17,src_org_mockito_internal_creation_MockSettingsImpl,33,15,35,2,0,2,18,3,0,0,35,2,0,2,18,3,0,0
Mockito/17,src_org_mockito_internal_util_MockUtil,31,9,47,16,0,0,11,2,0,0,47,16,0,0,11,2,0,0
Mockito/18,src_org_mockito_internal_stubbing_defaultanswers_ReturnsEmptyValues,15,4,62,47,0,0,6,2,0,0,42,27,20,20,6,2,0,0
Mockito/19,src_org_mockito_internal_configuration_injection_PropertyAndSetterInjection,34,7,45,11,0,0,9,2,0,0,45,11,0,0,9,2,0,0
Mockito/19,src_org_mockito_internal_configuration_injection_filter_FinalMockCandidateFilter,11,2,17,6,0,0,4,2,0,0,17,6,0,0,4,2,0,0
Mockito/19,src_org_mockito_internal_configuration_injection_filter_MockCandidateFilter,0,0,0,0,0,0,2,2,0,0,0,0,0,0,1,1,0,1
Mockito/19,src_org_mockito_internal_configuration_injection_filter_NameBasedCandidateFilter,2,3,13,11,0,0,5,2,0,0,13,11,0,0,5,2,0,0
Mockito/19,src_org_mockito_internal_configuration_injection_filter_TypeBasedCandidateFilter,2,2,10,8,0,0,4,2,0,0,10,8,0,0,4,2,0,0
Mockito/2,src_org_mockito_internal_util_Timer,5,4,7,2,0,0,6,2,0,0,7,2,0,0,6,2,0,0
Mockito/20,src_org_mockito_internal_creation_bytebuddy_ByteBuddyMockMaker,30,10,46,16,0,0,12,2,0,0,46,16,0,0,12,2,0,0
Mockito/21,src_org_mockito_internal_creation_instance_ConstructorInstantiator,10,4,20,10,0,1,7,3,0,0,14,4,0,7,6,2,0,1
Mockito/22,src_org_mockito_internal_matchers_Equality,12,4,21,9,0,0,6,2,0,0,21,9,0,0,6,2,0,0
Mockito/23,src_org_mockito_internal_stubbing_defaultanswers_ReturnsDeepStubs,20,7,33,13,0,0,13,6,0,0,33,13,0,0,13,6,0,0
Mockito/24,src_org_mockito_internal_stubbing_defaultanswers_ReturnsEmptyValues,47,4,62,15,0,0,6,2,0,0,60,13,0,2,6,2,0,0
Mockito/25,src_org_mockito_internal_stubbing_defaultanswers_ReturnsDeepStubs,5,4,24,19,0,0,8,4,0,0,21,16,0,3,7,3,0,1
Mockito/26,src_org_mockito_internal_util_Primitives,11,8,38,27,0,0,9,1,0,0,11,0,0,27,9,1,0,0
Mockito/27,src_org_mockito_internal_util_MockUtil,52,10,56,4,0,0,12,2,0,0,55,3,0,1,12,2,0,0
Mockito/28,src_org_mockito_internal_configuration_DefaultInjectionEngine,29,5,32,3,0,0,7,2,0,0,32,3,0,0,7,2,0,0
Mockito/29,src_org_mockito_internal_matchers_Same,11,5,17,6,0,0,7,2,0,0,17,6,0,0,7,2,0,0
Mockito/3,src_org_mockito_internal_invocation_InvocationMatcher,60,15,83,23,0,0,17,2,0,0,77,17,6,6,17,2,0,0
Mockito/30,src_org_mockito_exceptions_Reporter,124,49,126,2,0,0,51,2,0,0,126,2,0,0,51,2,0,0
Mockito/30,src_org_mockito_internal_stubbing_defaultanswers_ReturnsSmartNulls,15,7,21,6,0,0,10,3,0,0,21,6,0,0,10,3,0,0
Mockito/31,src_org_mockito_internal_stubbing_defaultanswers_ReturnsSmartNulls,18,7,20,2,0,0,10,3,0,0,19,1,0,1,10,3,0,0
Mockito/32,src_org_mockito_internal_configuration_SpyAnnotationEngine,8,2,32,24,0,0,4,2,0,0,32,24,0,0,4,2,0,0
Mockito/33,src_org_mockito_internal_invocation_InvocationMatcher,55,16,59,4,0,0,18,2,0,0,58,3,0,1,18,2,0,0
Mockito/34,src_org_mockito_internal_invocation_InvocationMatcher,43,15,51,8,0,0,17,2,0,0,51,8,0,0,17,2,0,0
Mockito/35,src_org_mockito_Matchers,92,47,98,6,0,0,51,4,0,0,98,6,0,0,51,4,0,0
Mockito/36,src_org_mockito_internal_invocation_Invocation,107,39,109,2,0,0,41,2,0,0,109,2,0,0,41,2,0,0
Mockito/37,src_org_mockito_internal_stubbing_answers_AnswersValidator,25,4,35,10,0,0,6,2,0,0,35,10,0,0,6,2,0,0
Mockito/38,src_org_mockito_internal_verification_argumentmatching_ArgumentMatchingTool,19,2,21,2,0,0,4,2,0,0,21,2,0,0,4,2,0,0
Mockito/4,src_org_mockito_exceptions_Reporter,177,71,185,8,0,0,75,4,0,0,185,8,0,0,75,4,0,0
Mockito/5,src_org_mockito_internal_verification_VerificationOverTimeImpl,28,13,48,20,0,0,15,2,0,0,48,20,0,0,15,2,0,0
Mockito/6,src_org_mockito_Matchers,66,34,106,40,0,0,55,21,0,0,101,35,0,5,55,21,0,0
Mockito/7,src_org_mockito_internal_util_reflection_GenericMetadataSupport,223,67,228,5,0,0,70,3,0,0,228,5,0,0,70,3,0,0
Mockito/8,src_org_mockito_internal_util_reflection_GenericMetadataSupport,211,68,227,16,0,0,70,2,0,0,227,16,0,0,70,2,0,0
Mockito/9,src_org_mockito_internal_stubbing_answers_CallsRealMethods,0,1,2,2,0,0,3,2,0,0,2,2,0,0,3,2,0,0
Time/1,src_main_java_org_joda_time_Partial,283,53,340,57,0,0,55,2,0,0,340,57,0,0,55,2,0,0
Time/1,src_main_java_org_joda_time_field_UnsupportedDurationField,69,27,71,2,0,0,29,2,0,0,71,2,0,0,29,2,0,0
Time/10,src_main_java_org_joda_time_base_BaseSingleFieldPeriod,83,19,101,18,0,0,21,2,0,0,101,18,0,0,21,2,0,0
Time/11,src_main_java_org_joda_time_tz_ZoneInfoCompiler,503,64,503,0,0,0,66,2,0,0,503,0,0,0,66,2,0,0
Time/12,src_main_java_org_joda_time_LocalDate,447,125,466,19,0,0,128,3,0,0,457,10,0,9,128,3,0,0
Time/12,src_main_java_org_joda_time_LocalDateTime,482,145,493,11,0,0,148,3,0,0,492,10,0,1,148,3,0,0
Time/13,src_main_java_org_joda_time_format_PeriodFormatterBuilder,900,158,950,50,0,0,162,4,0,0,950,50,0,0,162,4,0,0
Time/14,src_main_java_org_joda_time_chrono_BasicMonthOfYearDateTimeField,134,22,148,14,0,0,24,2,0,0,148,14,0,0,24,2,0,0
Time/15,src_main_java_org_joda_time_field_FieldUtils,90,15,103,13,0,0,17,2,0,0,103,13,0,0,17,2,0,0
Time/16,src_main_java_org_joda_time_format_DateTimeFormatter,251,52,276,25,0,0,54,2,0,0,276,25,0,0,54,2,0,0
Time/17,src_main_java_org_joda_time_DateTimeZone,448,67,457,9,0,0,69,2,0,0,453,5,0,4,69,2,0,0
Time/18,src_main_java_org_joda_time_chrono_GJChronology,474,94,488,14,0,0,96,2,0,0,488,14,0,0,96,2,0,0
Time/19,src_main_java_org_joda_time_DateTimeZone,432,67,459,27,0,0,69,2,0,0,456,24,0,3,69,2,0,0
Time/2,src_main_java_org_joda_time_Partial,235,52,337,102,0,0,55,3,0,0,337,102,0,0,55,3,0,0
Time/2,src_main_java_org_joda_time_field_UnsupportedDurationField,69,27,71,2,0,0,29,2,0,0,71,2,0,0,29,2,0,0
Time/20,src_main_java_org_joda_time_format_DateTimeFormatterBuilder,1458,224,1473,15,0,0,227,3,0,0,1466,8,1,7,227,3,0,0
Time/22,src_main_java_org_joda_time_base_BasePeriod,205,34,206,1,0,0,36,2,0,0,206,1,0,0,36,2,0,0
Time/23,src_main_java_org_joda_time_DateTimeZone,416,67,454,38,3,4,69,2,0,0,450,34,5,8,69,2,0,0
Time/24,src_main_java_org_joda_time_format_DateTimeParserBucket,135,48,177,42,0,0,50,2,0,0,177,42,0,0,50,2,0,0
Time/25,src_main_java_org_joda_time_DateTimeZone,423,66,440,17,0,0,68,2,0,0,437,14,0,3,68,2,0,0
Time/27,src_main_java_org_joda_time_format_PeriodFormatterBuilder,928,160,948,20,0,0,162,2,0,0,948,20,0,0,162,2,0,0
Time/3,src_main_java_org_joda_time_MutableDateTime,281,106,304,23,0,0,117,11,0,0,304,23,0,0,117,11,0,0
Time/4,src_main_java_org_joda_time_Partial,292,53,337,45,0,0,55,2,0,0,336,44,0,1,55,2,0,0
Time/5,src_main_java_org_joda_time_Period,347,87,365,18,0,2,89,2,0,0,365,18,0,2,89,2,0,0
Time/6,src_main_java_org_joda_time_chrono_GJChronology,442,91,507,65,0,0,96,5,0,0,507,65,0,0,96,5,0,0
Time/7,src_main_java_org_joda_time_format_DateTimeFormatter,251,52,277,26,0,0,54,2,0,0,276,25,0,1,54,2,0,0
Time/8,src_main_java_org_joda_time_DateTimeZone,452,68,478,26,0,0,70,2,0,0,475,23,0,3,70,2,0,0
Time/9,src_main_java_org_joda_time_DateTimeZone,446,66,472,26,0,0,69,3,0,0,464,18,0,8,69,3,0,0
