url,srcFileName,ignoredMappings,ignoredElements,RMD_TP_raw_abstractMapping,RMD_TP_abstractMapping,RMD_FP_abstractMapping,RMD_FN_abstractMapping,RMD_TP_raw_programElement,RMD_TP_programElement,RMD_FP_programElement,RMD_FN_programElement,GTG_TP_raw_abstractMapping,GTG_TP_abstractMapping,GTG_FP_abstractMapping,GTG_FN_abstractMapping,GTG_TP_raw_programElement,GTG_TP_programElement,GTG_FP_programElement,GTG_FN_programElement,GTS_TP_raw_abstractMapping,GTS_TP_abstractMapping,GTS_FP_abstractMapping,GTS_FN_abstractMapping,GTS_TP_raw_programElement,GTS_TP_programElement,GTS_FP_programElement,GTS_FN_programElement
Chart/1,source_org_jfree_chart_renderer_category_AbstractCategoryItemRenderer,1020,80,1064,44,0,0,82,2,0,0,1060,40,0,4,82,2,0,0,1064,44,0,0,82,2,0,0
Chart/10,source_org_jfree_chart_imagemap_StandardToolTipTagFragmentGenerator,4,1,15,11,0,0,3,2,0,0,15,11,0,0,3,2,0,0,14,10,0,1,3,2,0,0
Chart/11,source_org_jfree_chart_util_ShapeUtilities,337,21,379,42,0,0,23,2,0,0,376,39,0,3,23,2,0,0,379,42,0,0,23,2,0,0
Chart/12,source_org_jfree_chart_plot_MultiplePiePlot,302,28,326,24,0,0,30,2,0,0,323,21,1,3,30,2,0,0,324,22,0,2,30,2,0,0
Chart/13,source_org_jfree_chart_block_BorderArrangement,284,15,345,61,0,0,17,2,0,0,342,58,0,3,17,2,0,0,345,61,0,0,17,2,0,0
Chart/14,source_org_jfree_chart_plot_CategoryPlot,2226,217,2277,51,0,0,220,3,0,0,2274,48,0,3,220,3,0,0,2277,51,0,0,220,3,0,0
Chart/14,source_org_jfree_chart_plot_XYPlot,2779,252,2830,51,0,0,255,3,0,0,2827,48,0,3,255,3,0,0,2830,51,0,0,255,3,0,0
Chart/15,source_org_jfree_chart_plot_PiePlot,1443,170,1477,34,0,0,173,3,0,0,1474,31,0,3,173,3,0,0,1477,34,0,0,173,3,0,0
Chart/16,source_org_jfree_data_category_DefaultIntervalCategoryDataset,343,34,412,69,0,0,37,3,0,0,409,66,1,3,37,3,0,0,412,69,0,0,37,3,0,0
Chart/17,source_org_jfree_data_time_TimeSeries,543,52,557,14,0,0,54,2,0,0,549,6,0,8,53,1,0,1,557,14,0,0,54,2,0,0
Chart/18,source_org_jfree_data_DefaultKeyedValues,224,24,248,24,0,0,27,3,0,0,245,21,0,3,27,3,0,0,248,24,0,0,27,3,0,0
Chart/18,source_org_jfree_data_DefaultKeyedValues2D,270,27,288,18,0,0,29,2,0,0,285,15,0,3,29,2,0,0,288,18,0,0,29,2,0,0
Chart/19,source_org_jfree_chart_plot_CategoryPlot,2099,203,2129,30,0,0,206,3,0,0,2126,27,0,3,206,3,0,0,2129,30,0,0,206,3,0,0
Chart/2,source_org_jfree_data_general_DatasetUtilities,1308,50,1418,110,0,0,53,3,0,0,1414,106,0,4,53,3,0,0,1418,110,0,0,53,3,0,0
Chart/20,source_org_jfree_chart_plot_ValueMarker,44,6,61,17,0,0,8,2,0,0,61,17,0,0,8,2,0,0,61,17,0,0,8,2,0,0
Chart/21,source_org_jfree_data_statistics_DefaultBoxAndWhiskerCategoryDataset,340,44,396,56,0,0,47,3,0,0,388,48,1,8,46,2,0,1,392,52,0,4,46,2,0,1
Chart/22,source_org_jfree_data_KeyedObjects2D,183,21,259,76,0,0,26,5,0,0,251,68,2,8,26,5,0,0,255,72,3,4,26,5,0,0
Chart/23,source_org_jfree_chart_renderer_category_MinMaxCategoryRenderer,272,34,276,4,0,0,35,1,0,0,273,1,0,3,35,1,0,0,276,4,0,0,35,1,0,0
Chart/24,source_org_jfree_chart_renderer_GrayPaintScale,49,8,65,16,0,0,10,2,0,0,65,16,0,0,10,2,0,0,65,16,0,0,10,2,0,0
Chart/25,source_org_jfree_chart_renderer_category_StatisticalBarRenderer,93,12,297,204,0,0,15,3,0,0,288,195,10,9,15,3,0,0,291,198,8,6,15,3,0,0
Chart/26,source_org_jfree_chart_axis_Axis,567,98,653,86,0,0,100,2,0,0,649,82,0,4,100,2,0,0,653,86,0,0,100,2,0,0
Chart/3,source_org_jfree_data_time_TimeSeries,687,64,720,33,0,0,66,2,0,0,717,30,0,3,66,2,0,0,720,33,0,0,66,2,0,0
Chart/4,source_org_jfree_chart_plot_XYPlot,3198,290,3287,89,0,0,292,2,0,0,3284,86,0,3,292,2,0,0,3287,89,0,0,292,2,0,0
Chart/5,source_org_jfree_data_xy_XYSeries,346,38,385,39,0,0,40,2,0,0,382,36,0,3,40,2,0,0,385,39,0,0,40,2,0,0
Chart/6,source_org_jfree_chart_util_ShapeList,61,7,77,16,0,0,9,2,0,0,76,15,2,1,9,2,0,0,77,16,0,0,9,2,0,0
Chart/7,source_org_jfree_data_time_TimePeriodValues,229,38,297,68,0,0,40,2,0,0,294,65,0,3,40,2,0,0,297,68,0,0,40,2,0,0
Chart/8,source_org_jfree_data_time_Week,303,31,314,11,0,0,33,2,0,0,311,8,0,3,33,2,0,0,314,11,0,0,33,2,0,0
Chart/9,source_org_jfree_data_time_TimeSeries,512,52,558,46,0,0,54,2,0,0,555,43,0,3,54,2,0,0,558,46,0,0,54,2,0,0
Cli/1,src_java_org_apache_commons_cli_CommandLine,65,12,121,56,0,4,20,8,0,0,112,47,28,13,19,7,0,1,113,48,22,12,20,8,0,0
Cli/10,src_java_org_apache_commons_cli_Parser,193,14,206,13,0,0,16,2,0,0,202,9,0,4,16,2,0,0,206,13,0,0,16,2,0,0
Cli/11,src_java_org_apache_commons_cli_HelpFormatter,434,55,461,27,0,0,57,2,0,0,457,23,3,4,57,2,0,0,460,26,3,1,57,2,0,0
Cli/12,src_java_org_apache_commons_cli_GnuParser,0,0,45,45,0,0,2,2,0,0,45,45,0,0,2,2,0,0,45,45,0,0,2,2,0,0
Cli/13,src_java_org_apache_commons_cli2_WriteableCommandLine,27,7,31,4,0,0,8,1,0,0,31,4,0,0,8,1,0,0,31,4,0,0,8,1,0,0
Cli/13,src_java_org_apache_commons_cli2_commandline_WriteableCommandLineImpl,173,27,178,5,0,0,28,1,0,0,178,5,0,0,28,1,0,0,178,5,0,0,28,1,0,0
Cli/13,src_java_org_apache_commons_cli2_option_ArgumentImpl,211,37,254,43,0,1,39,2,0,0,252,41,0,3,39,2,0,0,255,44,0,0,39,2,0,0
Cli/14,src_java_org_apache_commons_cli2_option_GroupImpl,307,30,343,36,0,1,32,2,0,0,341,34,1,3,32,2,0,0,344,37,0,0,32,2,0,0
Cli/15,src_java_org_apache_commons_cli2_commandline_WriteableCommandLineImpl,200,30,224,24,0,0,32,2,0,0,217,17,4,7,32,2,0,0,220,20,2,4,32,2,0,0
Cli/16,src_java_org_apache_commons_cli2_Option,45,14,48,3,0,0,15,1,0,0,48,3,0,0,15,1,0,0,48,3,0,0,15,1,0,0
Cli/16,src_java_org_apache_commons_cli2_commandline_WriteableCommandLineImpl,213,30,228,15,0,0,32,2,0,0,225,12,0,3,32,2,0,0,228,15,0,0,32,2,0,0
Cli/16,src_java_org_apache_commons_cli2_option_GroupImpl,306,30,344,38,0,0,32,2,0,0,341,35,0,3,32,2,0,0,344,38,0,0,32,2,0,0
Cli/16,src_java_org_apache_commons_cli2_option_OptionImpl,119,14,124,5,0,0,15,1,0,0,124,5,0,0,15,1,0,0,124,5,0,0,15,1,0,0
Cli/17,src_java_org_apache_commons_cli_PosixParser,97,10,124,27,0,0,12,2,0,0,124,27,0,0,12,2,0,0,124,27,0,0,12,2,0,0
Cli/18,src_java_org_apache_commons_cli_PosixParser,59,8,118,59,0,0,11,3,0,0,116,57,3,2,11,3,0,0,115,56,5,3,11,3,0,0
Cli/19,src_java_org_apache_commons_cli_PosixParser,100,9,118,18,0,0,11,2,0,0,117,17,0,1,11,2,0,0,117,17,0,1,11,2,0,0
Cli/2,src_java_org_apache_commons_cli_PosixParser,98,10,126,28,0,0,12,2,0,0,126,28,1,0,12,2,0,0,124,26,1,2,12,2,0,0
Cli/20,src_java_org_apache_commons_cli_PosixParser,72,9,114,42,5,8,11,2,0,0,114,42,17,8,11,2,0,0,113,41,6,9,11,2,0,0
Cli/21,src_java_org_apache_commons_cli2_WriteableCommandLine,35,9,39,4,0,0,10,1,0,0,39,4,0,0,10,1,0,0,39,4,0,0,10,1,0,0
Cli/21,src_java_org_apache_commons_cli2_commandline_WriteableCommandLineImpl,209,29,233,24,0,0,32,3,0,0,228,19,2,5,32,3,0,0,231,22,2,2,32,3,0,0
Cli/21,src_java_org_apache_commons_cli2_option_GroupImpl,341,31,353,12,0,0,33,2,0,0,349,8,1,4,33,2,0,0,352,11,1,1,33,2,0,0
Cli/22,src_java_org_apache_commons_cli_PosixParser,16,5,103,87,0,2,10,5,0,0,100,84,7,5,10,5,0,0,98,82,8,7,10,5,0,0
Cli/23,src_java_org_apache_commons_cli_HelpFormatter,431,55,460,29,0,2,57,2,0,0,459,28,2,3,57,2,0,0,458,27,0,4,57,2,0,0
Cli/24,src_java_org_apache_commons_cli_HelpFormatter,431,55,463,32,0,0,57,2,0,0,460,29,3,3,57,2,0,0,463,32,0,0,57,2,0,0
Cli/25,src_java_org_apache_commons_cli_HelpFormatter,431,55,465,34,0,0,57,2,0,0,462,31,0,3,57,2,0,0,464,33,0,1,57,2,0,0
Cli/26,src_java_org_apache_commons_cli_OptionBuilder,152,28,175,23,0,0,30,2,0,0,173,21,2,2,30,2,0,0,174,22,0,1,30,2,0,0
Cli/27,src_java_org_apache_commons_cli_OptionGroup,57,11,78,21,0,0,13,2,0,0,78,21,0,0,13,2,0,0,78,21,0,0,13,2,0,0
Cli/28,src_java_org_apache_commons_cli_Parser,170,14,201,31,0,0,16,2,0,0,197,27,0,4,16,2,0,0,201,31,0,0,16,2,0,0
Cli/29,src_java_org_apache_commons_cli_Util,15,1,30,15,0,0,3,2,0,0,30,15,3,0,3,2,0,0,30,15,1,0,3,2,0,0
Cli/3,src_java_org_apache_commons_cli_TypeHandler,117,8,137,20,0,0,10,2,0,0,133,16,1,4,10,2,0,0,133,16,1,4,10,2,0,0
Cli/30,src_main_java_org_apache_commons_cli_DefaultParser,339,29,370,31,0,0,31,2,0,0,367,28,0,3,31,2,0,0,370,31,0,0,31,2,0,0
Cli/30,src_main_java_org_apache_commons_cli_Parser,177,15,212,35,0,0,17,2,0,0,207,30,6,5,17,2,0,0,212,35,0,0,17,2,0,0
Cli/31,src_main_java_org_apache_commons_cli_HelpFormatter,452,59,480,28,0,0,61,2,0,0,477,25,0,3,61,2,0,0,478,26,0,2,61,2,0,0
Cli/31,src_main_java_org_apache_commons_cli_Option,315,56,320,5,0,0,58,2,0,0,317,2,0,3,58,2,0,0,320,5,0,0,58,2,0,0
Cli/31,src_main_java_org_apache_commons_cli_OptionBuilder,160,28,179,19,0,0,30,2,0,0,179,19,0,0,30,2,0,0,178,18,0,1,30,2,0,0
Cli/32,src_main_java_org_apache_commons_cli_HelpFormatter,445,59,472,27,0,0,61,2,0,0,469,24,0,3,61,2,0,0,472,27,0,0,61,2,0,0
Cli/33,src_main_java_org_apache_commons_cli_HelpFormatter,458,59,473,15,0,0,61,2,0,0,470,12,0,3,61,2,0,0,473,15,0,0,61,2,0,0
Cli/34,src_main_java_org_apache_commons_cli_Option,315,56,320,5,0,0,58,2,0,0,317,2,0,3,58,2,0,0,320,5,0,0,58,2,0,0
Cli/34,src_main_java_org_apache_commons_cli_OptionBuilder,160,28,179,19,0,0,30,2,0,0,179,19,0,0,30,2,0,0,178,18,0,1,30,2,0,0
Cli/35,src_main_java_org_apache_commons_cli_Options,125,20,142,17,0,0,22,2,0,0,142,17,0,0,22,2,0,0,142,17,0,0,22,2,0,0
Cli/36,src_main_java_org_apache_commons_cli_OptionGroup,75,11,81,6,0,0,13,2,0,0,80,5,0,1,13,2,0,0,80,5,0,1,13,2,0,0
Cli/36,src_main_java_org_apache_commons_cli_Options,141,20,146,5,0,0,22,2,0,0,146,5,0,0,22,2,0,0,146,5,0,0,22,2,0,0
Cli/37,src_main_java_org_apache_commons_cli_DefaultParser,363,29,375,12,1,5,31,2,0,0,370,7,2,10,30,1,0,1,378,15,3,2,31,2,0,0
Cli/38,src_main_java_org_apache_commons_cli_DefaultParser,363,29,377,14,3,2,31,2,0,0,375,12,1,4,31,2,0,0,378,15,1,1,31,2,0,0
Cli/39,src_main_java_org_apache_commons_cli_TypeHandler,87,8,128,41,0,0,10,2,0,0,128,41,0,0,10,2,0,0,128,41,0,0,10,2,0,0
Cli/4,src_java_org_apache_commons_cli_Parser,168,11,186,18,0,0,13,2,0,0,182,14,0,4,13,2,0,0,186,18,0,0,13,2,0,0
Cli/40,src_main_java_org_apache_commons_cli_TypeHandler,99,9,140,41,0,0,11,2,0,0,140,41,0,0,11,2,0,0,139,40,0,1,11,2,0,0
Cli/5,src_java_org_apache_commons_cli_Util,12,1,26,14,0,0,3,2,0,0,26,14,0,0,3,2,0,0,26,14,0,0,3,2,0,0
Cli/7,src_java_org_apache_commons_cli2_builder_PatternBuilder,129,10,134,5,0,0,12,2,0,0,133,4,0,1,12,2,0,0,132,3,1,2,11,1,0,1
Cli/8,src_java_org_apache_commons_cli_HelpFormatter,418,52,445,27,0,0,54,2,0,0,442,24,0,3,54,2,0,0,444,26,0,1,54,2,0,0
Cli/9,src_java_org_apache_commons_cli_Parser,184,14,205,21,0,0,16,2,0,0,201,17,0,4,16,2,0,0,205,21,0,0,16,2,0,0
Closure/1,src_com_google_javascript_jscomp_RemoveUnusedVars,562,57,592,30,0,0,59,2,0,0,590,28,0,2,59,2,0,0,592,30,0,0,59,2,0,0
Closure/10,src_com_google_javascript_jscomp_NodeUtil,2507,190,2523,16,0,0,192,2,0,0,2519,12,0,4,192,2,0,0,2523,16,0,0,192,2,0,0
Closure/100,src_com_google_javascript_jscomp_CheckGlobalThis,39,7,86,47,0,0,10,3,0,0,85,46,1,1,10,3,0,0,85,46,1,1,10,3,0,0
Closure/101,src_com_google_javascript_jscomp_CommandLineRunner,153,50,175,22,0,2,52,2,0,0,173,20,0,4,52,2,0,0,175,22,0,2,52,2,0,0
Closure/102,src_com_google_javascript_jscomp_Normalize,365,35,384,19,0,0,37,2,0,0,382,17,0,2,37,2,0,0,384,19,0,0,37,2,0,0
Closure/103,src_com_google_javascript_jscomp_ControlFlowAnalysis,708,54,737,29,0,0,56,2,0,0,734,26,0,3,56,2,0,0,737,29,0,0,56,2,0,0
Closure/103,src_com_google_javascript_jscomp_DisambiguateProperties,769,94,801,32,0,0,97,3,0,0,799,30,0,2,97,3,0,0,801,32,0,0,97,3,0,0
Closure/104,src_com_google_javascript_rhino_jstype_UnionType,350,31,384,34,0,0,33,2,0,0,381,31,0,3,33,2,0,0,383,33,0,1,33,2,0,0
Closure/105,src_com_google_javascript_jscomp_FoldConstants,1430,57,1511,81,0,6,59,2,0,0,1515,85,0,2,59,2,0,0,1513,83,1,4,59,2,0,0
Closure/106,src_com_google_javascript_jscomp_GlobalNamespace,699,84,714,15,0,0,87,3,0,0,712,13,0,2,87,3,0,0,714,15,0,0,87,3,0,0
Closure/106,src_com_google_javascript_rhino_JSDocInfoBuilder,522,54,533,11,0,0,56,2,0,0,528,6,1,5,56,2,0,0,532,10,1,1,56,2,0,0
Closure/107,src_com_google_javascript_jscomp_CommandLineRunner,359,101,404,45,0,0,103,2,0,0,401,42,0,3,103,2,0,0,404,45,0,0,103,2,0,0
Closure/108,src_com_google_javascript_jscomp_ScopedAliases,283,50,415,132,0,0,55,5,0,0,410,127,0,5,55,5,0,0,415,132,0,0,55,5,0,0
Closure/109,src_com_google_javascript_jscomp_parsing_JsDocInfoParser,1798,101,1807,9,0,2,103,2,0,0,1804,6,1,5,103,2,0,0,1808,10,1,1,103,2,0,0
Closure/11,src_com_google_javascript_jscomp_TypeCheck,1111,87,1133,22,0,0,89,2,0,0,1129,18,2,4,89,2,0,0,1132,21,2,1,89,2,0,0
Closure/110,src_com_google_javascript_jscomp_ScopedAliases,351,52,397,46,0,0,55,3,0,0,392,41,5,5,55,3,0,0,395,44,2,2,55,3,0,0
Closure/110,src_com_google_javascript_rhino_Node,2225,315,2246,21,0,0,317,2,0,0,2243,18,0,3,317,2,0,0,2246,21,0,0,317,2,0,0
Closure/111,src_com_google_javascript_jscomp_type_ClosureReverseAbstractInterpreter,198,28,210,12,0,0,31,3,0,0,209,11,1,1,31,3,0,0,209,11,0,1,31,3,0,0
Closure/112,src_com_google_javascript_jscomp_TypeInference,1124,73,1145,21,0,0,75,2,0,0,1143,19,0,2,75,2,0,0,1145,21,0,0,75,2,0,0
Closure/113,src_com_google_javascript_jscomp_ProcessClosurePrimitives,787,82,821,34,0,0,84,2,0,0,819,32,0,2,84,2,0,0,821,34,0,0,84,2,0,0
Closure/114,src_com_google_javascript_jscomp_NameAnalyzer,1234,125,1263,29,0,0,128,3,0,0,1260,26,0,3,128,3,0,0,1263,29,0,0,128,3,0,0
Closure/115,src_com_google_javascript_jscomp_FunctionInjector,476,44,517,41,0,0,46,2,0,0,515,39,0,2,46,2,0,0,517,41,0,0,46,2,0,0
Closure/116,src_com_google_javascript_jscomp_FunctionInjector,476,44,517,41,0,0,46,2,0,0,515,39,0,2,46,2,0,0,517,41,0,0,46,2,0,0
Closure/117,src_com_google_javascript_jscomp_TypeValidator,471,58,513,42,0,0,60,2,0,0,511,40,0,2,60,2,0,0,513,42,0,0,60,2,0,0
Closure/118,src_com_google_javascript_jscomp_DisambiguateProperties,881,100,903,22,0,0,103,3,0,0,901,20,0,2,103,3,0,0,903,22,0,0,103,3,0,0
Closure/119,src_com_google_javascript_jscomp_GlobalNamespace,863,124,983,120,2,2,127,3,0,0,980,117,0,5,127,3,0,0,985,122,0,0,127,3,0,0
Closure/12,src_com_google_javascript_jscomp_MaybeReachingVariableUse,182,19,190,8,0,0,21,2,0,0,190,8,0,0,21,2,0,0,186,4,0,4,20,1,0,1
Closure/120,src_com_google_javascript_jscomp_ReferenceCollectingCallback,469,77,492,23,0,0,80,3,0,0,490,21,0,2,80,3,0,0,492,23,0,0,80,3,0,0
Closure/121,src_com_google_javascript_jscomp_InlineVariables,410,39,472,62,0,0,42,3,0,0,467,57,0,5,42,3,0,0,472,62,0,0,42,3,0,0
Closure/122,src_com_google_javascript_jscomp_parsing_IRFactory,1231,109,1243,12,2,0,111,2,0,0,1240,9,3,3,111,2,0,0,1243,12,2,0,111,2,0,0
Closure/123,src_com_google_javascript_jscomp_CodeGenerator,513,43,1017,504,0,1,45,2,0,0,975,462,0,43,45,2,0,0,1017,504,1,1,45,2,0,0
Closure/124,src_com_google_javascript_jscomp_ExploitAssigns,127,5,145,18,0,0,7,2,0,0,145,18,0,0,7,2,0,0,145,18,0,0,7,2,0,0
Closure/125,src_com_google_javascript_jscomp_TypeCheck,1260,97,1286,26,0,0,99,2,0,0,1283,23,0,3,99,2,0,0,1286,26,0,0,99,2,0,0
Closure/126,src_com_google_javascript_jscomp_MinimizeExitPoints,116,7,181,65,0,0,9,2,0,0,181,65,0,0,9,2,0,0,181,65,0,0,9,2,0,0
Closure/127,src_com_google_javascript_jscomp_UnreachableCodeElimination,111,13,148,37,0,0,16,3,0,0,148,37,0,0,16,3,0,0,148,37,0,0,16,3,0,0
Closure/128,src_com_google_javascript_jscomp_CodeGenerator,991,42,1009,18,0,0,44,2,0,0,1007,16,0,2,44,2,0,0,1009,18,0,0,44,2,0,0
Closure/129,src_com_google_javascript_jscomp_PrepareAst,127,14,147,20,0,0,17,3,0,0,147,20,0,0,17,3,0,0,147,20,0,0,17,3,0,0
Closure/13,src_com_google_javascript_jscomp_PeepholeOptimizationsPass,139,26,163,24,0,0,28,2,0,0,163,24,0,0,28,2,0,0,163,24,0,0,28,2,0,0
Closure/130,src_com_google_javascript_jscomp_CollapseProperties,514,31,543,29,0,0,33,2,0,0,541,27,0,2,33,2,0,0,543,29,0,0,33,2,0,0
Closure/131,src_com_google_javascript_rhino_TokenStream,326,1,347,21,0,0,3,2,0,0,344,18,1,3,3,2,0,0,347,21,0,0,3,2,0,0
Closure/132,src_com_google_javascript_jscomp_PeepholeSubstituteAlternateSyntax,1024,61,1170,146,0,0,63,2,0,0,1166,142,0,4,63,2,0,0,1170,146,0,0,63,2,0,0
Closure/133,src_com_google_javascript_jscomp_parsing_JsDocInfoParser,1691,91,1701,10,0,0,93,2,0,0,1697,6,0,4,93,2,0,0,1701,10,0,0,93,2,0,0
Closure/134,src_com_google_javascript_jscomp_AmbiguateProperties,354,61,435,81,0,0,68,7,0,0,432,78,10,3,68,7,0,0,433,79,6,2,68,7,0,0
Closure/134,src_com_google_javascript_jscomp_TypedScopeCreator,798,56,818,20,0,0,59,3,0,0,808,10,3,10,59,3,0,0,814,16,4,4,59,3,0,0
Closure/135,src_com_google_javascript_jscomp_DevirtualizePrototypeMethods,173,11,193,20,0,0,13,2,0,0,191,18,0,2,13,2,0,0,193,20,0,0,13,2,0,0
Closure/135,src_com_google_javascript_rhino_jstype_FunctionType,569,59,590,21,0,0,61,2,0,0,587,18,0,3,61,2,0,0,590,21,0,0,61,2,0,0
Closure/136,src_com_google_javascript_jscomp_MethodCompilerPass,146,19,162,16,0,0,21,2,0,0,161,15,1,1,21,2,0,0,161,15,2,1,21,2,0,0
Closure/136,src_com_google_javascript_jscomp_RenameVars,219,42,270,51,0,0,45,3,0,0,267,48,0,3,45,3,0,0,267,48,1,3,45,3,0,0
Closure/137,src_com_google_javascript_jscomp_MakeDeclaredNamesUnique,251,39,322,71,4,4,51,12,0,0,306,55,27,20,49,10,0,2,307,56,54,19,49,10,2,2
Closure/137,src_com_google_javascript_jscomp_NodeUtil,1491,120,1495,4,0,0,121,1,0,0,1491,0,0,4,121,1,0,0,1495,4,0,0,121,1,0,0
Closure/137,src_com_google_javascript_jscomp_Normalize,384,40,402,18,0,0,42,2,0,0,400,16,0,2,42,2,0,0,402,18,0,0,42,2,0,0
Closure/138,src_com_google_javascript_jscomp_ClosureReverseAbstractInterpreter,165,28,192,27,0,0,30,2,0,0,187,22,7,5,30,2,0,0,187,22,7,5,30,2,0,0
Closure/138,src_com_google_javascript_jscomp_TypeInference,842,57,871,29,3,0,59,2,0,0,869,27,0,2,59,2,0,0,871,29,0,0,59,2,0,0
Closure/139,src_com_google_javascript_jscomp_Normalize,346,32,410,64,0,0,43,11,0,0,408,62,0,2,43,11,0,0,410,64,0,0,43,11,0,0
Closure/14,src_com_google_javascript_jscomp_ControlFlowAnalysis,707,58,784,77,0,0,60,2,0,0,781,74,0,3,60,2,0,0,784,77,0,0,60,2,0,0
Closure/140,src_com_google_javascript_jscomp_Compiler,1193,182,1233,40,0,0,186,4,0,0,1230,37,1,3,186,4,0,0,1233,40,1,0,186,4,0,0
Closure/141,src_com_google_javascript_jscomp_NodeUtil,1478,120,1503,25,0,0,122,2,0,0,1499,21,0,4,122,2,0,0,1503,25,0,0,122,2,0,0
Closure/141,src_com_google_javascript_jscomp_PureFunctionIdentifier,416,49,444,28,0,2,51,2,0,0,442,26,2,4,51,2,0,0,444,28,2,2,51,2,0,0
Closure/142,src_com_google_javascript_jscomp_CoalesceVariableNames,291,34,313,22,0,0,36,2,0,0,311,20,0,2,36,2,0,0,313,22,0,0,36,2,0,0
Closure/142,src_com_google_javascript_jscomp_parsing_JsDocInfoParser,1337,76,1408,71,0,0,78,2,0,0,1404,67,0,4,78,2,0,0,1408,71,0,0,78,2,0,0
Closure/143,src_com_google_javascript_jscomp_AbstractCommandLineRunner,765,101,810,45,0,0,103,2,0,0,807,42,0,3,103,2,0,0,810,45,0,0,103,2,0,0
Closure/143,src_com_google_javascript_jscomp_RemoveConstantExpressions,61,13,83,22,0,0,16,3,0,0,83,22,0,0,16,3,0,0,83,22,0,0,16,3,0,0
Closure/144,src_com_google_javascript_jscomp_FunctionTypeBuilder,277,42,318,41,0,0,45,3,0,0,315,38,2,3,45,3,0,0,318,41,2,0,45,3,0,0
Closure/144,src_com_google_javascript_jscomp_TypedScopeCreator,847,70,918,71,0,0,73,3,0,0,909,62,4,9,73,3,0,0,916,69,4,2,73,3,0,0
Closure/144,src_com_google_javascript_rhino_jstype_FunctionBuilder,92,23,96,4,0,0,24,1,0,0,96,4,0,0,24,1,0,0,96,4,0,0,24,1,0,0
Closure/144,src_com_google_javascript_rhino_jstype_FunctionType,625,64,635,10,0,0,66,2,0,0,632,7,0,3,66,2,0,0,635,10,0,0,66,2,0,0
Closure/145,src_com_google_javascript_jscomp_CodeGenerator,805,33,813,8,0,0,35,2,0,0,807,2,1,6,34,1,0,1,812,7,1,1,35,2,0,0
Closure/146,src_com_google_javascript_rhino_jstype_JSType,581,96,602,21,0,0,98,2,0,0,598,17,0,4,98,2,0,0,602,21,0,0,98,2,0,0
Closure/147,src_com_google_javascript_jscomp_CheckGlobalThis,49,8,91,42,0,0,10,2,0,0,91,42,0,0,10,2,0,0,91,42,0,0,10,2,0,0
Closure/147,src_com_google_javascript_jscomp_RuntimeTypeCheck,233,23,270,37,0,0,28,5,0,0,268,35,0,2,28,5,0,0,270,37,0,0,28,5,0,0
Closure/148,src_com_google_javascript_jscomp_PeepholeFoldConstants,834,26,877,43,0,0,28,2,0,0,874,40,0,3,28,2,0,0,877,43,0,0,28,2,0,0
Closure/148,src_com_google_javascript_jscomp_SourceMap,63,23,261,198,5,9,39,16,0,0,214,151,40,56,32,9,3,7,218,155,30,52,35,12,3,4
Closure/149,src_com_google_javascript_jscomp_AbstractCommandLineRunner,870,114,946,76,0,0,118,4,0,0,943,73,0,3,118,4,0,0,946,76,0,0,118,4,0,0
Closure/149,src_com_google_javascript_jscomp_CommandLineRunner,167,56,189,22,0,0,58,2,0,0,186,19,0,3,58,2,0,0,189,22,0,0,58,2,0,0
Closure/149,src_com_google_javascript_jscomp_Compiler,1340,195,1357,17,0,2,197,2,0,0,1355,15,1,4,197,2,0,0,1357,17,1,2,197,2,0,0
Closure/149,src_com_google_javascript_jscomp_CompilerOptions,342,178,348,6,0,0,180,2,0,0,345,3,0,3,180,2,0,0,348,6,0,0,180,2,0,0
Closure/15,src_com_google_javascript_jscomp_FlowSensitiveInlineVariables,282,31,308,26,0,0,34,3,0,0,306,24,0,2,34,3,0,0,308,26,0,0,34,3,0,0
Closure/150,src_com_google_javascript_jscomp_TypedScopeCreator,958,79,981,23,0,0,82,3,0,0,978,20,4,3,82,3,0,0,981,23,1,0,82,3,0,0
Closure/151,src_com_google_javascript_jscomp_CommandLineRunner,144,55,189,45,0,0,58,3,0,0,186,42,0,3,58,3,0,0,189,45,0,0,58,3,0,0
Closure/152,src_com_google_javascript_rhino_jstype_FunctionType,630,64,661,31,0,0,66,2,0,0,657,27,1,4,66,2,0,0,660,30,1,1,66,2,0,0
Closure/154,src_com_google_javascript_jscomp_TypeCheck,1029,82,1084,55,0,0,85,3,0,0,1081,52,2,3,84,2,0,1,1084,55,2,0,84,2,0,1
Closure/154,src_com_google_javascript_jscomp_TypeValidator,463,52,482,19,0,0,55,3,0,0,480,17,2,2,54,2,0,1,482,19,0,0,55,3,0,0
Closure/155,src_com_google_javascript_jscomp_InlineVariables,348,36,433,85,0,0,40,4,0,0,428,80,0,5,40,4,0,0,431,83,0,2,40,4,0,0
Closure/155,src_com_google_javascript_jscomp_ReferenceCollectingCallback,377,65,399,22,0,0,67,2,0,0,395,18,2,4,67,2,0,0,398,21,0,1,67,2,0,0
Closure/155,src_com_google_javascript_jscomp_Scope,316,59,319,3,0,0,60,1,0,0,316,0,0,3,60,1,0,0,319,3,0,0,60,1,0,0
Closure/156,src_com_google_javascript_jscomp_CollapseProperties,372,26,494,122,0,0,32,6,0,0,492,120,0,2,32,6,0,0,491,119,0,3,32,6,0,0
Closure/157,src_com_google_javascript_jscomp_CodeGenerator,407,35,896,489,0,0,37,2,0,0,847,440,12,49,37,2,0,0,886,479,6,10,37,2,0,0
Closure/157,src_com_google_javascript_jscomp_RenamePrototypes,201,31,272,71,0,0,35,4,0,0,270,69,0,2,35,4,0,0,272,71,0,0,35,4,0,0
Closure/157,src_com_google_javascript_jscomp_parsing_IRFactory,1123,89,1143,20,2,1,92,3,0,0,1136,13,2,8,92,3,0,0,1141,18,4,3,92,3,0,0
Closure/158,src_com_google_javascript_jscomp_AbstractCommandLineRunner,979,130,1038,59,1,8,133,3,0,0,1032,53,11,14,133,3,1,0,1038,59,12,8,133,3,2,0
Closure/158,src_com_google_javascript_jscomp_CommandLineRunner,176,59,237,61,3,2,66,7,0,0,230,54,17,9,66,7,0,0,237,61,17,2,66,7,0,0
Closure/158,src_com_google_javascript_jscomp_DiagnosticGroups,40,29,52,12,0,0,31,2,0,0,51,11,1,1,31,2,0,0,51,11,1,1,31,2,0,0
Closure/159,src_com_google_javascript_jscomp_InlineFunctions,847,122,866,19,0,0,124,2,0,0,859,12,10,7,124,2,0,0,861,14,7,5,124,2,0,0
Closure/16,src_com_google_javascript_jscomp_ScopedAliases,296,46,342,46,0,0,52,6,0,0,336,40,2,6,52,6,0,0,335,39,4,7,51,5,0,1
Closure/160,src_com_google_javascript_jscomp_Compiler,1442,204,1478,36,1,8,206,2,0,0,1483,41,0,3,206,2,0,0,1485,43,3,1,206,2,0,0
Closure/161,src_com_google_javascript_jscomp_PeepholeFoldConstants,1049,36,1089,40,0,0,38,2,0,0,1087,38,0,2,38,2,0,0,1089,40,0,0,38,2,0,0
Closure/164,src_com_google_javascript_rhino_jstype_ArrowType,141,17,182,41,0,0,19,2,0,0,182,41,0,0,19,2,0,0,182,41,0,0,19,2,0,0
Closure/165,src_com_google_javascript_rhino_jstype_JSTypeRegistry,953,104,972,19,0,0,106,2,0,0,969,16,0,3,106,2,0,0,972,19,0,0,106,2,0,0
Closure/165,src_com_google_javascript_rhino_jstype_ObjectType,448,75,453,5,0,0,76,1,0,0,449,1,0,4,76,1,0,0,453,5,0,0,76,1,0,0
Closure/165,src_com_google_javascript_rhino_jstype_RecordType,81,9,159,78,0,0,13,4,0,0,155,74,4,4,12,3,1,1,155,74,4,4,12,3,1,1
Closure/165,src_com_google_javascript_rhino_jstype_RecordTypeBuilder,37,11,48,11,0,0,13,2,0,0,48,11,0,0,13,2,0,0,48,11,0,0,13,2,0,0
Closure/166,src_com_google_javascript_rhino_jstype_PrototypeObjectType,457,49,472,15,0,0,51,2,0,0,470,13,0,2,51,2,0,0,472,15,0,0,51,2,0,0
Closure/167,src_com_google_javascript_jscomp_type_SemanticReverseAbstractInterpreter,364,32,490,126,0,0,38,6,0,0,487,123,6,3,38,6,0,0,477,113,4,13,38,6,0,0
Closure/167,src_com_google_javascript_rhino_jstype_JSType,801,123,817,16,0,0,125,2,0,0,813,12,0,4,125,2,0,0,817,16,0,0,125,2,0,0
Closure/168,src_com_google_javascript_jscomp_TypedScopeCreator,1233,100,1286,53,0,0,105,5,0,0,1283,50,0,3,105,5,0,0,1286,53,0,0,105,5,0,0
Closure/169,src_com_google_javascript_rhino_jstype_ArrowType,172,18,213,41,0,0,21,3,0,0,211,39,2,2,21,3,0,0,209,37,0,4,21,3,0,0
Closure/169,src_com_google_javascript_rhino_jstype_FunctionType,823,82,883,60,0,0,86,4,0,0,879,56,1,4,86,4,0,0,881,58,0,2,86,4,0,0
Closure/169,src_com_google_javascript_rhino_jstype_JSType,821,125,908,87,0,0,130,5,0,0,887,66,7,21,128,3,0,2,902,81,4,6,130,5,0,0
Closure/169,src_com_google_javascript_rhino_jstype_RecordType,85,12,169,84,0,0,16,4,0,0,165,80,6,4,16,4,0,0,165,80,2,4,16,4,0,0
Closure/169,src_com_google_javascript_rhino_jstype_UnionType,486,40,520,34,0,0,43,3,0,0,515,29,3,5,43,3,0,0,516,30,0,4,43,3,0,0
Closure/17,src_com_google_javascript_jscomp_TypedScopeCreator,1217,102,1270,53,0,0,105,3,0,0,1262,45,2,8,105,3,0,0,1269,52,2,1,105,3,0,0
Closure/170,src_com_google_javascript_jscomp_FlowSensitiveInlineVariables,300,32,327,27,1,1,36,4,0,0,325,25,1,3,36,4,0,0,327,27,1,1,36,4,0,0
Closure/171,src_com_google_javascript_jscomp_TypeInference,1090,73,1132,42,0,0,75,2,0,0,1130,40,3,2,75,2,0,0,1132,42,3,0,75,2,0,0
Closure/171,src_com_google_javascript_jscomp_TypedScopeCreator,1321,106,1364,43,0,0,109,3,0,0,1357,36,0,7,109,3,0,0,1364,43,0,0,109,3,0,0
Closure/172,src_com_google_javascript_jscomp_TypedScopeCreator,1322,106,1368,46,0,0,109,3,0,0,1360,38,1,8,109,3,0,0,1367,45,1,1,109,3,0,0
Closure/173,src_com_google_javascript_jscomp_CodeGenerator,513,43,1013,500,0,0,45,2,0,0,1008,495,2,5,45,2,0,0,1010,497,3,3,45,2,0,0
Closure/173,src_com_google_javascript_jscomp_PeepholeSubstituteAlternateSyntax,410,26,448,38,0,0,28,2,0,0,445,35,1,3,28,2,0,0,448,38,0,0,28,2,0,0
Closure/175,src_com_google_javascript_jscomp_FunctionInjector,447,43,502,55,1,0,46,3,0,0,500,53,26,2,46,3,0,0,500,53,1,2,46,3,0,0
Closure/18,src_com_google_javascript_jscomp_Compiler,1761,239,1849,88,0,0,241,2,0,0,1846,85,0,3,241,2,0,0,1849,88,0,0,241,2,0,0
Closure/19,src_com_google_javascript_jscomp_type_ChainableReverseAbstractInterpreter,602,89,627,25,0,0,91,2,0,0,622,20,1,5,91,2,0,0,627,25,0,0,91,2,0,0
Closure/2,src_com_google_javascript_jscomp_TypeCheck,1158,91,1188,30,0,0,93,2,0,0,1185,27,0,3,93,2,0,0,1188,30,0,0,93,2,0,0
Closure/20,src_com_google_javascript_jscomp_PeepholeSubstituteAlternateSyntax,1150,60,1171,21,0,0,62,2,0,0,1169,19,0,2,62,2,0,0,1171,21,0,0,62,2,0,0
Closure/21,src_com_google_javascript_jscomp_CheckSideEffects,89,16,131,42,0,0,18,2,0,0,131,42,3,0,18,2,0,0,131,42,0,0,18,2,0,0
Closure/22,src_com_google_javascript_jscomp_CheckSideEffects,89,16,126,37,2,4,18,2,0,0,130,41,4,0,18,2,0,0,130,41,2,0,18,2,0,0
Closure/23,src_com_google_javascript_jscomp_PeepholeFoldConstants,1167,42,1212,45,0,1,44,2,0,0,1211,44,2,2,44,2,0,0,1213,46,0,0,44,2,0,0
Closure/24,src_com_google_javascript_jscomp_ScopedAliases,268,45,296,28,0,0,48,3,0,0,289,21,2,7,48,3,0,0,294,26,2,2,48,3,0,0
Closure/25,src_com_google_javascript_jscomp_TypeInference,958,62,985,27,3,3,64,2,0,0,983,25,0,5,64,2,0,0,988,30,0,0,64,2,0,0
Closure/26,src_com_google_javascript_jscomp_ProcessCommonJSModules,160,25,188,28,0,0,29,4,0,0,185,25,0,3,29,4,0,0,188,28,0,0,29,4,0,0
Closure/27,src_com_google_javascript_rhino_IR,704,69,732,28,0,0,72,3,0,0,729,25,0,3,72,3,0,0,732,28,0,0,72,3,0,0
Closure/28,src_com_google_javascript_jscomp_InlineCostEstimator,58,16,65,7,0,0,18,2,0,0,65,7,0,0,18,2,0,0,65,7,0,0,18,2,0,0
Closure/29,src_com_google_javascript_jscomp_InlineObjectLiterals,206,15,258,52,0,0,18,3,0,0,253,47,0,5,18,3,0,0,258,52,0,0,18,3,0,0
Closure/3,src_com_google_javascript_jscomp_FlowSensitiveInlineVariables,222,31,324,102,0,0,36,5,0,0,322,100,0,2,36,5,0,0,324,102,0,0,36,5,0,0
Closure/30,src_com_google_javascript_jscomp_FlowSensitiveInlineVariables,292,32,306,14,0,0,34,2,0,0,304,12,0,2,34,2,0,0,306,14,0,0,34,2,0,0
Closure/30,src_com_google_javascript_jscomp_MustBeReachingVariableDef,269,25,311,42,0,0,30,5,0,0,308,39,0,3,30,5,0,0,311,42,0,0,30,5,0,0
Closure/31,src_com_google_javascript_jscomp_Compiler,1694,233,1800,106,0,0,235,2,0,0,1797,103,0,3,235,2,0,0,1800,106,0,0,235,2,0,0
Closure/32,src_com_google_javascript_jscomp_parsing_JsDocInfoParser,1566,89,1637,71,0,0,91,2,0,0,1633,67,0,4,91,2,0,0,1636,70,0,1,91,2,0,0
Closure/33,src_com_google_javascript_rhino_jstype_PrototypeObjectType,441,48,462,21,0,0,50,2,0,0,460,19,0,2,50,2,0,0,462,21,0,0,50,2,0,0
Closure/34,src_com_google_javascript_jscomp_CodeGenerator,448,37,959,511,1,2,40,3,0,0,955,507,9,6,40,3,0,0,959,511,5,2,40,3,0,0
Closure/34,src_com_google_javascript_jscomp_CodePrinter,444,80,466,22,0,0,83,3,0,0,464,20,0,2,83,3,0,0,466,22,0,0,83,3,0,0
Closure/35,src_com_google_javascript_jscomp_TypeInference,981,62,994,13,0,2,64,2,0,0,993,12,6,3,64,2,0,0,994,13,2,2,64,2,0,0
Closure/36,src_com_google_javascript_jscomp_InlineVariables,424,39,463,39,0,0,42,3,0,0,458,34,0,5,42,3,0,0,463,39,0,0,42,3,0,0
Closure/37,src_com_google_javascript_jscomp_NodeTraversal,505,70,532,27,0,0,72,2,0,0,529,24,0,3,72,2,0,0,532,27,0,0,72,2,0,0
Closure/37,src_com_google_javascript_jscomp_parsing_IRFactory,1048,96,1096,48,0,0,99,3,0,0,1091,43,0,5,99,3,0,0,1096,48,0,0,99,3,0,0
Closure/38,src_com_google_javascript_jscomp_CodeConsumer,189,35,220,31,0,0,37,2,0,0,220,31,0,0,37,2,0,0,220,31,0,0,37,2,0,0
Closure/39,src_com_google_javascript_rhino_jstype_PrototypeObjectType,405,47,447,42,0,0,49,2,0,0,445,40,0,2,49,2,0,0,444,39,0,3,49,2,0,0
Closure/4,src_com_google_javascript_rhino_jstype_NamedType,242,33,271,29,0,0,35,2,0,0,269,27,0,2,35,2,0,0,271,29,0,0,35,2,0,0
Closure/40,src_com_google_javascript_jscomp_NameAnalyzer,1130,121,1187,57,0,0,124,3,0,0,1180,50,7,7,124,3,0,0,1179,49,10,8,124,3,0,0
Closure/41,src_com_google_javascript_jscomp_FunctionTypeBuilder,456,77,551,95,0,0,80,3,0,0,548,92,0,3,80,3,0,0,551,95,0,0,80,3,0,0
Closure/42,src_com_google_javascript_jscomp_parsing_IRFactory,1081,96,1092,11,0,0,99,3,0,0,1087,6,0,5,99,3,0,0,1092,11,0,0,99,3,0,0
Closure/43,src_com_google_javascript_jscomp_TypedScopeCreator,1151,100,1231,80,0,0,104,4,0,0,1224,73,0,7,104,4,0,0,1231,80,0,0,104,4,0,0
Closure/44,src_com_google_javascript_jscomp_CodeConsumer,199,35,215,16,0,0,37,2,0,0,215,16,0,0,37,2,0,0,215,16,0,0,37,2,0,0
Closure/45,src_com_google_javascript_jscomp_RemoveUnusedVars,526,55,582,56,0,2,59,4,0,0,581,55,4,3,59,4,0,0,581,55,1,3,59,4,0,0
Closure/46,src_com_google_javascript_rhino_jstype_RecordType,156,12,159,3,0,0,13,1,0,0,159,3,0,0,13,1,0,0,159,3,0,0,13,1,0,0
Closure/47,src_com_google_debugging_sourcemap_SourceMapConsumerV3,545,76,566,21,0,0,78,2,0,0,563,18,0,3,78,2,0,0,566,21,0,0,78,2,0,0
Closure/47,src_com_google_javascript_jscomp_SourceMap,115,24,133,18,0,0,26,2,0,0,133,18,0,0,26,2,0,0,133,18,0,0,26,2,0,0
Closure/48,src_com_google_javascript_jscomp_TypedScopeCreator,1136,100,1213,77,1,2,103,3,0,0,1206,70,1,9,103,3,0,0,1213,77,2,2,103,3,0,0
Closure/49,src_com_google_javascript_jscomp_MakeDeclaredNamesUnique,353,62,425,72,4,8,66,4,0,0,431,78,5,2,66,4,0,0,432,79,2,1,66,4,0,0
Closure/5,src_com_google_javascript_jscomp_InlineObjectLiterals,206,15,268,62,0,0,18,3,0,0,263,57,0,5,18,3,0,0,268,62,0,0,18,3,0,0
Closure/50,src_com_google_javascript_jscomp_PeepholeReplaceKnownMethods,381,14,475,94,0,0,16,2,0,0,473,92,0,2,16,2,0,0,475,94,0,0,16,2,0,0
Closure/51,src_com_google_javascript_jscomp_CodeConsumer,180,34,210,30,0,0,36,2,0,0,210,30,0,0,36,2,0,0,210,30,0,0,36,2,0,0
Closure/52,src_com_google_javascript_jscomp_CodeGenerator,921,39,937,16,0,0,41,2,0,0,935,14,0,2,41,2,0,0,937,16,0,0,41,2,0,0
Closure/53,src_com_google_javascript_jscomp_InlineObjectLiterals,205,15,254,49,0,0,18,3,0,0,249,44,0,5,18,3,0,0,254,49,0,0,18,3,0,0
Closure/54,src_com_google_javascript_jscomp_TypedScopeCreator,1047,90,1118,71,0,0,93,3,0,0,1111,64,0,7,93,3,0,0,1118,71,0,0,93,3,0,0
Closure/54,src_com_google_javascript_rhino_jstype_FunctionType,708,71,754,46,0,0,74,3,0,0,750,42,1,4,74,3,0,0,753,45,1,1,74,3,0,0
Closure/55,src_com_google_javascript_jscomp_FunctionRewriter,339,53,350,11,0,0,55,2,0,0,342,3,0,8,54,1,0,1,350,11,0,0,55,2,0,0
Closure/56,src_com_google_javascript_jscomp_SourceFile,344,59,380,36,0,0,61,2,0,0,376,32,1,4,61,2,0,0,379,35,1,1,61,2,0,0
Closure/57,src_com_google_javascript_jscomp_ClosureCodingConvention,271,25,298,27,0,0,27,2,0,0,295,24,0,3,27,2,0,0,298,27,0,0,27,2,0,0
Closure/58,src_com_google_javascript_jscomp_LiveVariablesAnalysis,150,24,227,77,0,0,26,2,0,0,225,75,0,2,26,2,0,0,227,77,0,0,26,2,0,0
Closure/59,src_com_google_javascript_jscomp_Compiler,1471,207,1514,43,0,0,209,2,0,0,1511,40,0,3,209,2,0,0,1514,43,0,0,209,2,0,0
Closure/6,src_com_google_javascript_jscomp_TypeValidator,471,57,507,36,0,0,60,3,0,0,501,30,5,6,60,3,0,0,501,30,8,6,60,3,0,0
Closure/60,src_com_google_javascript_jscomp_NodeUtil,2259,188,2335,76,0,0,191,3,0,0,2329,70,2,6,191,3,0,0,2334,75,1,1,191,3,0,0
Closure/61,src_com_google_javascript_jscomp_NodeUtil,2286,189,2328,42,0,0,191,2,0,0,2324,38,0,4,191,2,0,0,2328,42,0,0,191,2,0,0
Closure/62,src_com_google_javascript_jscomp_LightweightMessageFormatter,90,11,133,43,0,0,13,2,0,0,133,43,0,0,13,2,0,0,133,43,0,0,13,2,0,0
Closure/64,src_com_google_javascript_jscomp_Compiler,1411,201,1482,71,0,0,206,5,0,0,1479,68,0,3,206,5,0,0,1482,71,0,0,206,5,0,0
Closure/65,src_com_google_javascript_jscomp_CodeGenerator,862,39,937,75,0,0,41,2,0,0,935,73,0,2,41,2,0,0,937,75,0,0,41,2,0,0
Closure/66,src_com_google_javascript_jscomp_TypeCheck,865,87,1149,284,0,0,89,2,0,0,1105,240,0,44,89,2,0,0,1149,284,0,0,89,2,0,0
Closure/67,src_com_google_javascript_jscomp_AnalyzePrototypeProperties,451,84,475,24,0,0,87,3,0,0,470,19,0,5,87,3,0,0,475,24,0,0,87,3,0,0
Closure/68,src_com_google_javascript_jscomp_parsing_JsDocInfoParser,970,85,1603,633,0,0,89,4,0,0,1595,625,0,8,89,4,0,0,1603,633,0,0,89,4,0,0
Closure/69,src_com_google_javascript_jscomp_TypeCheck,1111,87,1146,35,0,0,89,2,0,0,1143,32,0,3,89,2,0,0,1146,35,0,0,89,2,0,0
Closure/7,src_com_google_javascript_jscomp_type_ChainableReverseAbstractInterpreter,609,88,637,28,0,0,91,3,0,0,628,19,2,9,91,3,0,0,631,22,0,6,91,3,0,0
Closure/70,src_com_google_javascript_jscomp_TypedScopeCreator,1147,91,1179,32,0,0,94,3,0,0,1176,29,0,3,94,3,0,0,1179,32,0,0,94,3,0,0
Closure/71,src_com_google_javascript_jscomp_CheckAccessControls,335,39,392,57,0,0,41,2,0,0,390,55,3,2,41,2,0,0,392,57,0,0,41,2,0,0
Closure/72,src_com_google_javascript_jscomp_FunctionToBlockMutator,240,18,250,10,0,0,20,2,0,0,248,8,0,2,20,2,0,0,250,10,0,0,20,2,0,0
Closure/72,src_com_google_javascript_jscomp_RenameLabels,123,25,157,34,0,0,28,3,0,0,157,34,0,0,28,3,0,0,156,33,0,1,28,3,0,0
Closure/73,src_com_google_javascript_jscomp_CodeGenerator,851,37,926,75,0,0,39,2,0,0,924,73,0,2,39,2,0,0,926,75,0,0,39,2,0,0
Closure/74,src_com_google_javascript_jscomp_PeepholeFoldConstants,1173,42,1326,153,0,2,44,2,0,0,1324,151,0,4,44,2,0,0,1322,149,0,6,44,2,0,0
Closure/75,src_com_google_javascript_jscomp_NodeUtil,2266,184,2315,49,3,3,187,3,0,0,2314,48,0,4,187,3,0,0,2318,52,0,0,187,3,0,0
Closure/76,src_com_google_javascript_jscomp_DeadAssignmentsElimination,192,14,255,63,0,3,17,3,0,0,250,58,4,8,17,3,0,0,254,62,4,4,17,3,0,0
Closure/77,src_com_google_javascript_jscomp_CodeGenerator,814,35,885,71,0,0,37,2,0,0,883,69,0,2,37,2,0,0,885,71,0,0,37,2,0,0
Closure/78,src_com_google_javascript_jscomp_PeepholeFoldConstants,1195,41,1266,71,0,0,43,2,0,0,1264,69,0,2,43,2,0,0,1266,71,0,0,43,2,0,0
Closure/79,src_com_google_javascript_jscomp_Normalize,503,48,525,22,0,0,50,2,0,0,523,20,0,2,50,2,0,0,525,22,0,0,50,2,0,0
Closure/79,src_com_google_javascript_jscomp_VarCheck,140,21,155,15,0,0,23,2,0,0,155,15,0,0,23,2,0,0,155,15,0,0,23,2,0,0
Closure/8,src_com_google_javascript_jscomp_CollapseVariableDeclarations,110,14,134,24,0,0,17,3,0,0,134,24,1,0,17,3,0,0,134,24,0,0,17,3,0,0
Closure/80,src_com_google_javascript_jscomp_NodeUtil,2244,184,2316,72,0,0,187,3,0,0,2312,68,0,4,187,3,0,0,2316,72,0,0,187,3,0,0
Closure/81,src_com_google_javascript_jscomp_parsing_IRFactory,1063,82,1106,43,0,0,85,3,0,0,1100,37,0,6,85,3,0,0,1106,43,0,0,85,3,0,0
Closure/82,src_com_google_javascript_rhino_jstype_JSType,651,102,662,11,0,0,104,2,0,0,658,7,0,4,104,2,0,0,662,11,0,0,104,2,0,0
Closure/83,src_com_google_javascript_jscomp_CommandLineRunner,160,57,197,37,0,0,61,4,0,0,192,32,2,5,61,4,0,0,196,36,0,1,61,4,0,0
Closure/84,src_com_google_javascript_jscomp_parsing_IRFactory,1027,77,1057,30,0,0,81,4,0,0,1051,24,0,6,81,4,0,0,1057,30,0,0,81,4,0,0
Closure/85,src_com_google_javascript_jscomp_UnreachableCodeElimination,85,11,129,44,0,0,14,3,0,0,129,44,0,0,14,3,0,0,129,44,0,0,14,3,0,0
Closure/86,src_com_google_javascript_jscomp_NodeUtil,1874,153,1921,47,4,4,155,2,0,0,1921,47,0,4,155,2,0,0,1925,51,0,0,155,2,0,0
Closure/87,src_com_google_javascript_jscomp_PeepholeSubstituteAlternateSyntax,672,33,688,16,0,0,35,2,0,0,676,4,2,12,34,1,0,1,688,16,0,0,35,2,0,0
Closure/88,src_com_google_javascript_jscomp_DeadAssignmentsElimination,197,14,224,27,0,0,16,2,0,0,222,25,0,2,16,2,0,0,223,26,0,1,16,2,0,0
Closure/89,src_com_google_javascript_jscomp_CollapseProperties,434,30,467,33,0,0,32,2,0,0,465,31,0,2,32,2,0,0,467,33,0,0,32,2,0,0
Closure/89,src_com_google_javascript_jscomp_GlobalNamespace,699,85,725,26,0,0,88,3,0,0,723,24,0,2,88,3,0,0,725,26,0,0,88,3,0,0
Closure/9,src_com_google_javascript_jscomp_ProcessCommonJSModules,155,27,193,38,0,0,31,4,0,0,189,34,2,4,31,4,0,0,192,37,2,1,31,4,0,0
Closure/90,src_com_google_javascript_jscomp_FunctionTypeBuilder,414,52,432,18,0,0,55,3,0,0,429,15,0,3,55,3,0,0,432,18,0,0,55,3,0,0
Closure/90,src_com_google_javascript_rhino_jstype_FunctionType,630,64,663,33,0,0,66,2,0,0,660,30,0,3,66,2,0,0,663,33,0,0,66,2,0,0
Closure/91,src_com_google_javascript_jscomp_CheckGlobalThis,49,8,90,41,0,0,10,2,0,0,90,41,0,0,10,2,0,0,90,41,0,0,10,2,0,0
Closure/92,src_com_google_javascript_jscomp_ProcessClosurePrimitives,548,60,604,56,0,0,63,3,0,0,602,54,0,2,63,3,0,0,604,56,0,0,63,3,0,0
Closure/94,src_com_google_javascript_jscomp_NodeUtil,1724,141,1753,29,0,0,143,2,0,0,1749,25,0,4,143,2,0,0,1753,29,0,0,143,2,0,0
Closure/95,src_com_google_javascript_jscomp_TypedScopeCreator,947,81,1000,53,0,0,84,3,0,0,993,46,0,7,84,3,0,0,1000,53,0,0,84,3,0,0
Closure/96,src_com_google_javascript_jscomp_TypeCheck,1008,82,1040,32,0,0,84,2,0,0,1036,28,0,4,84,2,0,0,1039,31,0,1,84,2,0,0
Closure/97,src_com_google_javascript_jscomp_PeepholeFoldConstants,829,26,881,52,0,0,28,2,0,0,877,48,1,4,28,2,0,0,880,51,1,1,28,2,0,0
Closure/98,src_com_google_javascript_jscomp_ReferenceCollectingCallback,352,59,377,25,0,0,64,5,0,0,375,23,0,2,64,5,0,0,377,25,0,0,64,5,0,0
Closure/99,src_com_google_javascript_jscomp_CheckGlobalThis,49,8,93,44,0,0,10,2,0,0,90,41,4,3,10,2,0,0,85,36,3,8,10,2,0,0
Codec/1,src_java_org_apache_commons_codec_language_Caverphone,27,4,99,72,0,0,6,2,0,0,99,72,0,0,6,2,0,0,99,72,0,0,6,2,0,0
Codec/1,src_java_org_apache_commons_codec_language_Metaphone,89,15,303,214,0,0,17,2,0,0,298,209,0,5,17,2,0,0,303,214,0,0,17,2,0,0
Codec/1,src_java_org_apache_commons_codec_language_SoundexUtils,26,2,49,23,0,0,4,2,0,0,49,23,0,0,4,2,0,0,49,23,0,0,4,2,0,0
Codec/10,src_java_org_apache_commons_codec_language_Caverphone,27,4,100,73,0,0,6,2,0,0,100,73,0,0,6,2,0,0,100,73,0,0,6,2,0,0
Codec/12,src_main_java_org_apache_commons_codec_binary_BaseNCodecInputStream,66,7,70,4,0,0,8,1,0,0,70,4,0,0,8,1,0,0,70,4,0,0,8,1,0,0
Codec/13,src_main_java_org_apache_commons_codec_binary_StringUtils,141,17,144,3,0,0,18,1,0,0,141,0,0,3,18,1,0,0,144,3,0,0,18,1,0,0
Codec/13,src_main_java_org_apache_commons_codec_language_DoubleMetaphone,862,59,875,13,0,2,61,2,0,0,872,10,0,5,61,2,0,0,875,13,0,2,61,2,0,0
Codec/14,src_main_java_org_apache_commons_codec_language_bm_Lang,108,14,117,9,0,0,16,2,0,0,117,9,0,0,16,2,0,0,115,7,1,2,15,1,0,1
Codec/14,src_main_java_org_apache_commons_codec_language_bm_PhoneticEngine,265,38,303,38,0,1,40,2,0,0,300,35,3,4,40,2,0,0,303,38,1,1,40,2,0,0
Codec/14,src_main_java_org_apache_commons_codec_language_bm_Rule,525,63,560,35,0,0,66,3,0,0,557,32,0,3,66,3,0,0,560,35,0,0,66,3,0,0
Codec/16,src_main_java_org_apache_commons_codec_binary_Base32,247,24,251,4,0,0,26,2,0,0,248,1,0,3,26,2,0,0,251,4,0,0,26,2,0,0
Codec/17,src_main_java_org_apache_commons_codec_binary_StringUtils,169,19,181,12,0,0,21,2,0,0,178,9,1,3,21,2,0,0,179,10,0,2,21,2,0,0
Codec/2,src_java_org_apache_commons_codec_binary_Base64,382,51,448,66,0,0,53,2,0,0,445,63,0,3,53,2,0,0,448,66,0,0,53,2,0,0
Codec/3,src_java_org_apache_commons_codec_language_DoubleMetaphone,891,65,949,58,0,0,67,2,0,0,946,55,0,3,67,2,0,0,949,58,0,0,67,2,0,0
Codec/4,src_java_org_apache_commons_codec_binary_Base64,499,60,508,9,0,0,62,2,0,0,505,6,0,3,62,2,0,0,508,9,0,0,62,2,0,0
Codec/5,src_java_org_apache_commons_codec_binary_Base64,456,61,508,52,0,0,63,2,0,0,505,49,0,3,63,2,0,0,508,52,0,0,63,2,0,0
Codec/6,src_java_org_apache_commons_codec_binary_Base64InputStream,41,8,80,39,0,0,10,2,0,0,78,37,1,2,10,2,0,0,78,37,1,2,10,2,0,0
Codec/7,src_java_org_apache_commons_codec_binary_Base64,499,61,512,13,0,0,63,2,0,0,509,10,0,3,63,2,0,0,512,13,0,0,63,2,0,0
Codec/8,src_java_org_apache_commons_codec_binary_Base64,480,61,485,5,0,0,62,1,0,0,482,2,0,3,62,1,0,0,485,5,0,0,62,1,0,0
Codec/8,src_java_org_apache_commons_codec_binary_Base64InputStream,41,8,80,39,0,0,10,2,0,0,80,39,0,0,10,2,0,0,80,39,0,0,10,2,0,0
Codec/9,src_java_org_apache_commons_codec_binary_Base64,476,62,500,24,0,0,64,2,0,0,497,21,0,3,64,2,0,0,498,22,0,2,64,2,0,0
Collections/25,src_main_java_org_apache_commons_collections4_IteratorUtils,735,72,769,34,0,0,76,4,0,0,763,28,3,6,76,4,0,0,766,31,3,3,76,4,0,0
Collections/26,src_main_java_org_apache_commons_collections4_keyvalue_MultiKey,108,16,117,9,0,0,18,2,0,0,117,9,0,0,18,2,0,0,117,9,0,0,18,2,0,0
Collections/27,src_main_java_org_apache_commons_collections4_map_MultiValueMap,349,46,357,8,0,0,48,2,0,0,354,5,0,3,48,2,0,0,357,8,0,0,48,2,0,0
Collections/28,src_main_java_org_apache_commons_collections4_trie_AbstractPatriciaTrie,1851,214,1858,7,0,0,216,2,0,0,1855,4,0,3,216,2,0,0,1858,7,0,0,216,2,0,0
Compress/1,src_main_java_org_apache_commons_compress_archivers_cpio_CpioArchiveOutputStream,280,26,294,14,0,0,28,2,0,0,291,11,0,3,28,2,0,0,294,14,0,0,28,2,0,0
Compress/10,src_main_java_org_apache_commons_compress_archivers_zip_ZipFile,459,65,501,42,0,0,67,2,0,0,496,37,4,5,67,2,0,0,499,40,5,2,67,2,0,0
Compress/11,src_main_java_org_apache_commons_compress_archivers_ArchiveStreamFactory,61,8,117,56,0,0,10,2,0,0,117,56,0,0,10,2,0,0,117,56,0,0,10,2,0,0
Compress/12,src_main_java_org_apache_commons_compress_archivers_tar_TarArchiveInputStream,303,30,358,55,0,0,32,2,0,0,355,52,0,3,32,2,0,0,358,55,0,0,32,2,0,0
Compress/13,src_main_java_org_apache_commons_compress_archivers_zip_ZipArchiveEntry,386,56,398,12,0,0,58,2,0,0,391,5,0,7,57,1,0,1,398,12,0,0,58,2,0,0
Compress/14,src_main_java_org_apache_commons_compress_archivers_tar_TarUtils,180,13,226,46,0,0,15,2,0,0,222,42,3,4,15,2,0,0,226,46,0,0,15,2,0,0
Compress/15,src_main_java_org_apache_commons_compress_archivers_zip_ZipArchiveEntry,361,56,399,38,0,0,58,2,0,0,394,33,2,5,58,2,0,0,394,33,1,5,58,2,0,0
Compress/16,src_main_java_org_apache_commons_compress_archivers_ArchiveStreamFactory,61,8,118,57,0,2,10,2,0,0,120,59,0,0,10,2,0,0,120,59,0,0,10,2,0,0
Compress/17,src_main_java_org_apache_commons_compress_archivers_tar_TarUtils,359,25,405,46,0,0,27,2,0,0,402,43,0,3,27,2,0,0,405,46,0,0,27,2,0,0
Compress/18,src_main_java_org_apache_commons_compress_archivers_tar_TarArchiveOutputStream,321,48,355,34,0,0,50,2,0,0,352,31,0,3,50,2,0,0,355,34,0,0,50,2,0,0
Compress/19,src_main_java_org_apache_commons_compress_archivers_zip_Zip64ExtendedInformationExtraField,174,25,211,37,0,0,27,2,0,0,208,34,0,3,27,2,0,0,211,37,0,0,27,2,0,0
Compress/2,src_main_java_org_apache_commons_compress_archivers_ar_ArArchiveInputStream,54,7,132,78,1,2,12,5,0,0,133,79,8,1,12,5,0,0,130,76,0,4,11,4,0,1
Compress/20,src_main_java_org_apache_commons_compress_archivers_cpio_CpioArchiveInputStream,277,28,375,98,0,0,32,4,0,0,372,95,0,3,32,4,0,0,369,92,0,6,32,4,0,0
Compress/21,src_main_java_org_apache_commons_compress_archivers_sevenz_SevenZOutputFile,605,46,630,25,3,4,48,2,0,0,631,26,0,3,48,2,0,0,631,26,1,3,48,2,0,0
Compress/22,src_main_java_org_apache_commons_compress_compressors_bzip2_BZip2CompressorInputStream,659,71,776,117,0,0,78,7,0,0,773,114,0,3,78,7,0,0,776,117,0,0,78,7,0,0
Compress/23,src_main_java_org_apache_commons_compress_archivers_sevenz_Coders,252,32,274,22,0,4,35,3,0,0,276,24,0,2,35,3,0,0,278,26,0,0,35,3,0,0
Compress/24,src_main_java_org_apache_commons_compress_archivers_tar_TarUtils,359,25,402,43,0,0,27,2,0,0,397,38,1,5,27,2,0,0,399,40,1,3,27,2,0,0
Compress/25,src_main_java_org_apache_commons_compress_archivers_zip_ZipArchiveInputStream,677,72,692,15,0,0,74,2,0,0,689,12,0,3,74,2,0,0,692,15,0,0,74,2,0,0
Compress/26,src_main_java_org_apache_commons_compress_utils_IOUtils,82,9,103,21,0,0,11,2,0,0,103,21,0,0,11,2,0,0,103,21,0,0,11,2,0,0
Compress/27,src_main_java_org_apache_commons_compress_archivers_tar_TarUtils,359,25,399,40,0,0,27,2,0,0,396,37,0,3,27,2,0,0,399,40,0,0,27,2,0,0
Compress/28,src_main_java_org_apache_commons_compress_archivers_tar_TarArchiveInputStream,392,40,421,29,0,0,42,2,0,0,418,26,0,3,42,2,0,0,421,29,0,0,42,2,0,0
Compress/29,src_main_java_org_apache_commons_compress_archivers_ArchiveStreamFactory,88,15,212,124,0,0,18,3,0,0,207,119,2,5,18,3,0,0,210,122,2,2,18,3,0,0
Compress/29,src_main_java_org_apache_commons_compress_archivers_cpio_CpioArchiveInputStream,361,33,375,14,0,0,35,2,0,0,372,11,0,3,35,2,0,0,375,14,0,0,35,2,0,0
Compress/29,src_main_java_org_apache_commons_compress_archivers_cpio_CpioArchiveOutputStream,346,30,370,24,0,0,32,2,0,0,367,21,0,3,32,2,0,0,370,24,0,0,32,2,0,0
Compress/29,src_main_java_org_apache_commons_compress_archivers_dump_DumpArchiveInputStream,292,30,321,29,0,0,32,2,0,0,318,26,0,3,32,2,0,0,321,29,0,0,32,2,0,0
Compress/29,src_main_java_org_apache_commons_compress_archivers_tar_TarArchiveInputStream,423,42,439,16,0,0,44,2,0,0,436,13,0,3,44,2,0,0,439,16,0,0,44,2,0,0
Compress/29,src_main_java_org_apache_commons_compress_archivers_tar_TarArchiveOutputStream,427,58,445,18,0,0,60,2,0,0,442,15,0,3,60,2,0,0,445,18,0,0,60,2,0,0
Compress/29,src_main_java_org_apache_commons_compress_archivers_zip_ZipArchiveInputStream,677,72,693,16,0,0,74,2,0,0,690,13,0,3,74,2,0,0,693,16,0,0,74,2,0,0
Compress/3,src_main_java_org_apache_commons_compress_archivers_tar_TarArchiveOutputStream,107,23,164,57,0,0,27,4,0,0,164,57,0,0,27,4,0,0,164,57,0,0,27,4,0,0
Compress/30,src_main_java_org_apache_commons_compress_compressors_bzip2_BZip2CompressorInputStream,740,76,775,35,0,0,78,2,0,0,772,32,0,3,78,2,0,0,775,35,0,0,78,2,0,0
Compress/31,src_main_java_org_apache_commons_compress_archivers_tar_TarUtils,358,25,398,40,0,0,27,2,0,0,395,37,0,3,27,2,0,0,398,40,0,0,27,2,0,0
Compress/32,src_main_java_org_apache_commons_compress_archivers_tar_TarArchiveInputStream,397,43,444,47,0,0,45,2,0,0,441,44,0,3,45,2,0,0,444,47,0,0,45,2,0,0
Compress/33,src_main_java_org_apache_commons_compress_compressors_CompressorStreamFactory,96,17,141,45,0,0,19,2,0,0,141,45,0,0,19,2,0,0,141,45,0,0,19,2,0,0
Compress/33,src_main_java_org_apache_commons_compress_compressors_deflate_DeflateCompressorInputStream,54,8,58,4,0,0,9,1,0,0,58,4,0,0,9,1,0,0,58,4,0,0,9,1,0,0
Compress/34,src_main_java_org_apache_commons_compress_archivers_zip_X7875_NewUnix,149,23,159,10,0,1,25,2,0,0,160,11,1,0,25,2,0,0,160,11,0,0,25,2,0,0
Compress/35,src_main_java_org_apache_commons_compress_archivers_tar_TarUtils,370,25,391,21,0,1,27,2,0,0,389,19,0,3,27,2,0,0,391,21,0,1,27,2,0,0
Compress/36,src_main_java_org_apache_commons_compress_archivers_sevenz_SevenZFile,846,38,864,18,0,0,40,2,0,0,861,15,0,3,40,2,0,0,864,18,0,0,40,2,0,0
Compress/37,src_main_java_org_apache_commons_compress_archivers_tar_TarArchiveInputStream,424,46,472,48,0,0,48,2,0,0,469,45,0,3,48,2,0,0,472,48,0,0,48,2,0,0
Compress/38,src_main_java_org_apache_commons_compress_archivers_tar_TarArchiveEntry,638,100,659,21,0,0,102,2,0,0,656,18,0,3,102,2,0,0,659,21,0,0,102,2,0,0
Compress/39,src_main_java_org_apache_commons_compress_utils_ArchiveUtils,170,13,195,25,0,0,15,2,0,0,192,22,0,3,15,2,0,0,195,25,0,0,15,2,0,0
Compress/4,src_main_java_org_apache_commons_compress_archivers_cpio_CpioArchiveOutputStream,260,24,274,14,0,0,26,2,0,0,271,11,0,3,26,2,0,0,274,14,0,0,26,2,0,0
Compress/4,src_main_java_org_apache_commons_compress_archivers_tar_TarArchiveOutputStream,154,26,168,14,0,0,28,2,0,0,168,14,0,0,28,2,0,0,168,14,0,0,28,2,0,0
Compress/4,src_main_java_org_apache_commons_compress_archivers_zip_ZipArchiveOutputStream,437,71,452,15,0,0,73,2,0,0,449,12,0,3,73,2,0,0,452,15,0,0,73,2,0,0
Compress/4,src_main_java_org_apache_commons_compress_changes_ChangeSetPerformer,37,4,96,59,0,0,6,2,0,0,96,59,0,0,6,2,0,0,96,59,0,0,6,2,0,0
Compress/40,src_main_java_org_apache_commons_compress_utils_BitInputStream,20,9,59,39,1,1,11,2,0,0,60,40,0,0,11,2,0,0,60,40,0,0,11,2,0,0
Compress/41,src_main_java_org_apache_commons_compress_archivers_zip_ZipArchiveInputStream,620,74,708,88,0,0,76,2,0,0,705,85,0,3,76,2,0,0,708,88,0,0,76,2,0,0
Compress/42,src_main_java_org_apache_commons_compress_archivers_zip_UnixStat,0,7,3,3,0,0,8,1,0,0,3,3,0,0,8,1,0,0,3,3,0,0,8,1,0,0
Compress/42,src_main_java_org_apache_commons_compress_archivers_zip_ZipArchiveEntry,499,77,510,11,0,0,79,2,0,0,507,8,0,3,79,2,0,0,510,11,0,0,79,2,0,0
Compress/43,src_main_java_org_apache_commons_compress_archivers_zip_ZipArchiveOutputStream,788,144,899,111,0,0,149,5,0,0,896,108,0,3,149,5,0,0,898,110,0,1,149,5,0,0
Compress/44,src_main_java_org_apache_commons_compress_utils_ChecksumCalculatingInputStream,49,7,60,11,0,0,9,2,0,0,60,11,0,0,9,2,0,0,60,11,0,0,9,2,0,0
Compress/45,src_main_java_org_apache_commons_compress_archivers_tar_TarUtils,374,25,397,23,0,0,27,2,0,0,394,20,0,3,27,2,0,0,397,23,0,0,27,2,0,0
Compress/46,src_main_java_org_apache_commons_compress_archivers_zip_X5455_ExtendedTimestamp,270,44,286,16,2,2,46,2,0,0,283,13,3,5,46,2,0,0,286,16,1,2,46,2,0,0
Compress/47,src_main_java_org_apache_commons_compress_archivers_zip_ZipArchiveInputStream,676,73,729,53,0,0,76,3,0,0,726,50,0,3,76,3,0,0,729,53,0,0,76,3,0,0
Compress/5,src_main_java_org_apache_commons_compress_archivers_zip_ZipArchiveInputStream,190,27,253,63,0,0,29,2,0,0,249,59,1,4,29,2,0,0,252,62,1,1,29,2,0,0
Compress/6,src_main_java_org_apache_commons_compress_archivers_zip_ZipArchiveEntry,265,43,299,34,0,0,46,3,0,0,296,31,0,3,46,3,0,0,299,34,0,0,46,3,0,0
Compress/7,src_main_java_org_apache_commons_compress_archivers_tar_TarUtils,129,9,150,21,0,1,11,2,0,0,149,20,3,2,11,2,0,0,150,21,0,1,11,2,0,0
Compress/9,src_main_java_org_apache_commons_compress_archivers_tar_TarArchiveOutputStream,150,27,195,45,0,0,29,2,0,0,195,45,0,0,29,2,0,0,195,45,0,0,29,2,0,0
Csv/1,src_main_java_org_apache_commons_csv_ExtendedBufferedReader,67,10,83,16,0,0,12,2,0,0,83,16,0,0,12,2,0,0,83,16,0,0,12,2,0,0
Csv/10,src_main_java_org_apache_commons_csv_CSVPrinter,278,17,295,17,0,0,19,2,0,0,291,13,0,4,19,2,0,0,295,17,0,0,19,2,0,0
Csv/11,src_main_java_org_apache_commons_csv_CSVParser,192,25,231,39,0,0,27,2,0,0,227,35,0,4,27,2,0,0,231,39,0,0,27,2,0,0
Csv/12,src_main_java_org_apache_commons_csv_CSVFormat,432,60,438,6,0,0,62,2,0,0,434,2,0,4,62,2,0,0,438,6,0,0,62,2,0,0
Csv/13,src_main_java_org_apache_commons_csv_CSVFormat,542,79,548,6,0,0,81,2,0,0,544,2,0,4,81,2,0,0,548,6,0,0,81,2,0,0
Csv/13,src_main_java_org_apache_commons_csv_CSVPrinter,279,17,306,27,0,0,19,2,0,0,302,23,0,4,19,2,0,0,306,27,0,0,19,2,0,0
Csv/14,src_main_java_org_apache_commons_csv_CSVFormat,730,100,818,88,0,0,102,2,0,0,814,84,0,4,102,2,0,0,818,88,0,0,102,2,0,0
Csv/15,src_main_java_org_apache_commons_csv_CSVFormat,757,106,843,86,0,0,108,2,0,0,838,81,2,5,108,2,0,0,842,85,2,1,108,2,0,0
Csv/16,src_main_java_org_apache_commons_csv_CSVParser,256,29,281,25,0,2,32,3,0,0,275,19,0,8,31,2,0,1,279,23,0,4,31,2,0,1
Csv/2,src_main_java_org_apache_commons_csv_CSVRecord,63,17,77,14,0,0,19,2,0,0,77,14,0,0,19,2,0,0,77,14,0,0,19,2,0,0
Csv/3,src_main_java_org_apache_commons_csv_Lexer,83,22,112,29,0,0,24,2,0,0,112,29,0,0,24,2,0,0,112,29,0,0,24,2,0,0
Csv/4,src_main_java_org_apache_commons_csv_CSVParser,206,24,216,10,0,0,26,2,0,0,212,6,0,4,26,2,0,0,216,10,0,0,26,2,0,0
Csv/5,src_main_java_org_apache_commons_csv_CSVPrinter,276,17,290,14,0,0,19,2,0,0,286,10,0,4,19,2,0,0,290,14,0,0,19,2,0,0
Csv/6,src_main_java_org_apache_commons_csv_CSVRecord,96,21,111,15,0,0,23,2,0,0,111,15,0,0,23,2,0,0,111,15,0,0,23,2,0,0
Csv/7,src_main_java_org_apache_commons_csv_CSVParser,192,25,224,32,0,0,27,2,0,0,220,28,0,4,27,2,0,0,224,32,0,0,27,2,0,0
Csv/8,src_main_java_org_apache_commons_csv_CSVFormat,350,55,409,59,1,7,58,3,0,0,412,62,5,4,58,3,0,0,415,65,1,1,58,3,0,0
Csv/9,src_main_java_org_apache_commons_csv_CSVRecord,96,21,113,17,0,0,23,2,0,0,113,17,0,0,23,2,0,0,113,17,0,0,23,2,0,0
Gson/1,gson_src_main_java_com_google_gson_TypeInfoFactory,49,5,96,47,0,0,7,2,0,0,96,47,0,0,7,2,0,0,96,47,0,0,7,2,0,0
Gson/10,gson_src_main_java_com_google_gson_internal_bind_ReflectiveTypeAdapterFactory,222,25,261,39,0,0,28,3,0,0,257,35,0,4,28,3,0,0,261,39,0,0,28,3,0,0
Gson/11,gson_src_main_java_com_google_gson_internal_bind_TypeAdapters,1043,139,1063,20,0,0,142,3,0,0,1059,16,0,4,142,3,0,0,1063,20,0,0,142,3,0,0
Gson/12,gson_src_main_java_com_google_gson_internal_bind_JsonTreeReader,317,31,336,19,0,0,33,2,0,0,331,14,1,5,33,2,0,0,335,18,1,1,33,2,0,0
Gson/13,gson_src_main_java_com_google_gson_stream_JsonReader,1077,81,1180,103,0,0,83,2,0,0,1177,100,0,3,83,2,0,0,1180,103,0,0,83,2,0,0
Gson/14,gson_src_main_java_com_google_gson_internal_$Gson$Types,498,50,520,22,0,0,53,3,0,0,516,18,0,4,53,3,0,0,520,22,0,0,53,3,0,0
Gson/15,gson_src_main_java_com_google_gson_stream_JsonWriter,372,43,411,39,0,0,45,2,0,0,408,36,0,3,45,2,0,0,411,39,0,0,45,2,0,0
Gson/16,gson_src_main_java_com_google_gson_internal_$Gson$Types,466,52,538,72,0,0,54,2,0,0,534,68,0,4,54,2,0,0,538,72,0,0,54,2,0,0
Gson/17,gson_src_main_java_com_google_gson_DefaultDateTypeAdapter,83,13,105,22,1,4,15,2,0,0,109,26,1,0,15,2,0,0,109,26,0,0,15,2,0,0
Gson/18,gson_src_main_java_com_google_gson_internal_$Gson$Types,530,52,543,13,0,0,54,2,0,0,539,9,0,4,54,2,0,0,543,13,0,0,54,2,0,0
Gson/2,gson_src_main_java_com_google_gson_internal_bind_TypeAdapters,917,121,942,25,0,1,124,3,0,0,939,22,1,4,124,3,0,0,943,26,0,0,124,3,0,0
Gson/3,gson_src_main_java_com_google_gson_internal_ConstructorConstructor,157,19,196,39,0,0,21,2,0,0,195,38,2,1,21,2,0,0,195,38,2,1,21,2,0,0
Gson/4,gson_src_main_java_com_google_gson_stream_JsonReader,1020,82,1156,136,0,0,84,2,0,0,1153,133,0,3,84,2,0,0,1156,136,0,0,84,2,0,0
Gson/4,gson_src_main_java_com_google_gson_stream_JsonWriter,241,34,397,156,0,0,44,10,0,0,394,153,0,3,44,10,0,0,389,148,0,8,44,10,0,0
Gson/5,gson_src_main_java_com_google_gson_internal_bind_util_ISO8601Utils,122,9,243,121,0,0,11,2,0,0,240,118,0,3,11,2,0,0,243,121,0,0,11,2,0,0
Gson/6,gson_src_main_java_com_google_gson_internal_bind_JsonAdapterAnnotationTypeAdapterFactory,19,3,47,28,0,0,5,2,0,0,47,28,0,0,5,2,0,0,47,28,0,0,5,2,0,0
Gson/7,gson_src_main_java_com_google_gson_stream_JsonReader,1063,81,1158,95,0,0,84,3,0,0,1153,90,2,5,84,3,0,0,1156,93,2,2,84,3,0,0
Gson/8,gson_src_main_java_com_google_gson_internal_UnsafeAllocator,15,2,79,64,0,0,7,5,0,0,79,64,0,0,7,5,0,0,79,64,0,0,7,5,0,0
Gson/9,gson_src_main_java_com_google_gson_internal_bind_JsonTreeWriter,212,25,217,5,0,0,26,1,0,0,217,5,0,0,26,1,0,0,217,5,0,0,26,1,0,0
Gson/9,gson_src_main_java_com_google_gson_internal_bind_TypeAdapters,1050,139,1063,13,0,0,142,3,0,0,1059,9,0,4,142,3,0,0,1063,13,0,0,142,3,0,0
Gson/9,gson_src_main_java_com_google_gson_stream_JsonWriter,372,43,397,25,0,0,44,1,0,0,394,22,0,3,44,1,0,0,397,25,0,0,44,1,0,0
JacksonCore/1,src_main_java_com_fasterxml_jackson_core_io_NumberInput,269,15,291,22,0,0,18,3,0,0,285,16,2,6,18,3,0,0,289,20,2,2,18,3,0,0
JacksonCore/1,src_main_java_com_fasterxml_jackson_core_util_TextBuffer,433,44,454,21,0,0,46,2,0,0,450,17,0,4,46,2,0,0,454,21,0,0,46,2,0,0
JacksonCore/10,src_main_java_com_fasterxml_jackson_core_sym_ByteQuadsCanonicalizer,800,77,842,42,3,2,80,3,0,0,840,40,0,4,80,3,0,0,844,44,0,0,80,3,0,0
JacksonCore/11,src_main_java_com_fasterxml_jackson_core_sym_ByteQuadsCanonicalizer,831,78,847,16,0,0,80,2,0,0,843,12,0,4,80,2,0,0,847,16,0,0,80,2,0,0
JacksonCore/12,src_main_java_com_fasterxml_jackson_core_json_ReaderBasedJsonParser,1994,78,2380,386,0,0,85,7,0,0,2377,383,2,3,85,7,0,0,2380,386,0,0,85,7,0,0
JacksonCore/12,src_main_java_com_fasterxml_jackson_core_json_UTF8StreamJsonParser,3156,112,3170,14,0,0,114,2,0,0,3167,11,2,3,114,2,0,0,3170,14,0,0,114,2,0,0
JacksonCore/13,src_main_java_com_fasterxml_jackson_core_json_JsonGeneratorImpl,90,17,95,5,0,0,18,1,0,0,95,5,0,0,18,1,0,0,95,5,0,0,18,1,0,0
JacksonCore/14,src_main_java_com_fasterxml_jackson_core_io_IOContext,169,33,200,31,0,0,37,4,0,0,200,31,0,0,37,4,0,0,200,31,0,0,37,4,0,0
JacksonCore/15,src_main_java_com_fasterxml_jackson_core_filter_FilteringParserDelegate,655,62,825,170,0,0,64,2,0,0,822,167,0,3,64,2,0,0,825,170,0,0,64,2,0,0
JacksonCore/17,src_main_java_com_fasterxml_jackson_core_json_UTF8JsonGenerator,1732,95,1797,65,0,2,99,4,0,0,1796,64,2,3,99,4,0,0,1799,67,0,0,99,4,0,0
JacksonCore/18,src_main_java_com_fasterxml_jackson_core_base_GeneratorBase,326,47,338,12,0,0,50,3,0,0,331,5,2,7,48,1,1,2,338,12,2,0,49,2,1,1
JacksonCore/18,src_main_java_com_fasterxml_jackson_core_json_UTF8JsonGenerator,1826,98,1846,20,0,0,100,2,0,0,1835,9,1,11,99,1,0,1,1842,16,3,4,100,2,0,0
JacksonCore/18,src_main_java_com_fasterxml_jackson_core_json_WriterBasedJsonGenerator,1662,74,1683,21,0,0,76,2,0,0,1671,9,1,12,75,1,0,1,1679,17,3,4,76,2,0,0
JacksonCore/19,src_main_java_com_fasterxml_jackson_core_json_ReaderBasedJsonParser,2283,83,2391,108,0,0,85,2,0,0,2388,105,0,3,85,2,0,0,2391,108,0,0,85,2,0,0
JacksonCore/19,src_main_java_com_fasterxml_jackson_core_json_UTF8StreamJsonParser,3082,112,3170,88,0,0,114,2,0,0,3167,85,0,3,114,2,0,0,3170,88,0,0,114,2,0,0
JacksonCore/2,src_main_java_com_fasterxml_jackson_core_json_ReaderBasedJsonParser,1408,57,1628,220,0,0,61,4,0,0,1624,216,0,4,61,4,0,0,1628,220,0,0,61,4,0,0
JacksonCore/2,src_main_java_com_fasterxml_jackson_core_json_UTF8StreamJsonParser,2402,87,2667,265,0,0,93,6,0,0,2663,261,0,4,93,6,0,0,2667,265,0,0,93,6,0,0
JacksonCore/20,src_main_java_com_fasterxml_jackson_core_JsonGenerator,906,112,920,14,0,0,114,2,0,0,911,5,1,9,113,1,0,1,920,14,0,0,114,2,0,0
JacksonCore/21,src_main_java_com_fasterxml_jackson_core_filter_FilteringParserDelegate,670,64,853,183,0,0,66,2,0,0,849,179,1,4,66,2,0,0,852,182,1,1,66,2,0,0
JacksonCore/22,src_main_java_com_fasterxml_jackson_core_filter_FilteringParserDelegate,419,62,849,430,0,0,66,4,0,0,835,416,9,14,66,4,0,0,836,417,7,13,66,4,0,0
JacksonCore/23,src_main_java_com_fasterxml_jackson_core_util_DefaultPrettyPrinter,278,45,289,11,0,0,47,2,0,0,283,5,0,6,46,1,0,1,289,11,0,0,47,2,0,0
JacksonCore/25,src_main_java_com_fasterxml_jackson_core_json_ReaderBasedJsonParser,2463,91,2511,48,0,0,93,2,0,0,2508,45,0,3,93,2,0,0,2511,48,0,0,93,2,0,0
JacksonCore/26,src_main_java_com_fasterxml_jackson_core_json_async_NonBlockingJsonParser,2502,76,2531,29,0,0,78,2,0,0,2528,26,0,3,78,2,0,0,2531,29,0,0,78,2,0,0
JacksonCore/3,src_main_java_com_fasterxml_jackson_core_json_UTF8StreamJsonParser,2700,93,2724,24,0,0,95,2,0,0,2721,21,0,3,95,2,0,0,2724,24,0,0,95,2,0,0
JacksonCore/4,src_main_java_com_fasterxml_jackson_core_util_TextBuffer,454,45,466,12,0,4,47,2,0,0,462,8,4,8,47,2,0,0,467,13,0,3,47,2,0,0
JacksonCore/5,src_main_java_com_fasterxml_jackson_core_JsonPointer,171,23,199,28,0,0,25,2,0,0,199,28,0,0,25,2,0,0,198,27,0,1,25,2,0,0
JacksonCore/6,src_main_java_com_fasterxml_jackson_core_JsonPointer,171,23,201,30,0,0,25,2,0,0,200,29,0,1,25,2,0,0,199,28,0,2,25,2,0,0
JacksonCore/7,src_main_java_com_fasterxml_jackson_core_json_JsonWriteContext,155,28,175,20,0,0,30,2,0,0,175,20,0,0,30,2,0,0,175,20,0,0,30,2,0,0
JacksonCore/8,src_main_java_com_fasterxml_jackson_core_util_TextBuffer,464,46,483,19,0,0,48,2,0,0,479,15,0,4,48,2,0,0,483,19,0,0,48,2,0,0
JacksonCore/9,src_main_java_com_fasterxml_jackson_core_base_ParserMinimalBase,547,70,576,29,0,0,73,3,0,0,572,25,0,4,73,3,0,0,576,29,0,0,73,3,0,0
JacksonCore/9,src_main_java_com_fasterxml_jackson_core_json_ReaderBasedJsonParser,1945,69,1980,35,0,0,72,3,0,0,1977,32,0,3,72,3,0,0,1980,35,0,0,72,3,0,0
JacksonCore/9,src_main_java_com_fasterxml_jackson_core_json_UTF8StreamJsonParser,3100,106,3133,33,0,0,109,3,0,0,3130,30,0,3,109,3,0,0,3133,33,0,0,109,3,0,0
JacksonDatabind/1,src_main_java_com_fasterxml_jackson_databind_ser_BeanPropertyWriter,405,56,454,49,0,0,58,2,0,0,451,46,0,3,58,2,0,0,454,49,0,0,58,2,0,0
JacksonDatabind/10,src_main_java_com_fasterxml_jackson_databind_ser_AnyGetterWriter,0,3,61,61,0,1,8,5,0,0,61,61,3,1,8,5,0,0,59,59,3,3,8,5,0,0
JacksonDatabind/10,src_main_java_com_fasterxml_jackson_databind_ser_BeanSerializerFactory,390,21,456,66,0,2,23,2,0,0,453,63,1,5,23,2,0,0,455,65,0,3,23,2,0,0
JacksonDatabind/100,src_main_java_com_fasterxml_jackson_databind_node_TreeTraversingParser,334,38,352,18,0,0,40,2,0,0,343,9,1,9,39,1,0,1,351,17,0,1,40,2,0,0
JacksonDatabind/101,src_main_java_com_fasterxml_jackson_databind_deser_BeanDeserializer,757,39,837,80,0,0,41,2,0,0,834,77,0,3,41,2,0,0,837,80,0,0,41,2,0,0
JacksonDatabind/102,src_main_java_com_fasterxml_jackson_databind_ser_std_DateTimeSerializerBase,101,13,161,60,0,0,15,2,0,0,161,60,0,0,15,2,0,0,161,60,0,0,15,2,0,0
JacksonDatabind/103,src_main_java_com_fasterxml_jackson_databind_DatabindContext,204,25,236,32,0,0,27,2,0,0,231,27,1,5,27,2,0,0,234,30,0,2,27,2,0,0
JacksonDatabind/103,src_main_java_com_fasterxml_jackson_databind_DeserializationContext,1039,106,1079,40,0,0,109,3,0,0,1073,34,2,6,109,3,0,0,1077,38,2,2,109,3,0,0
JacksonDatabind/103,src_main_java_com_fasterxml_jackson_databind_JsonMappingException,350,52,392,42,0,0,55,3,0,0,387,37,2,5,55,3,0,0,387,37,1,5,55,3,0,0
JacksonDatabind/103,src_main_java_com_fasterxml_jackson_databind_SerializerProvider,795,84,839,44,0,0,87,3,0,0,833,38,2,6,87,3,0,0,833,38,0,6,87,3,0,0
JacksonDatabind/103,src_main_java_com_fasterxml_jackson_databind_deser_BasicDeserializerFactory,1539,69,1596,57,0,0,71,2,0,0,1591,52,1,5,71,2,0,0,1595,56,1,1,71,2,0,0
JacksonDatabind/103,src_main_java_com_fasterxml_jackson_databind_deser_BeanDeserializerFactory,514,24,609,95,0,0,27,3,0,0,604,90,2,5,27,3,0,0,605,91,0,4,27,3,0,0
JacksonDatabind/103,src_main_java_com_fasterxml_jackson_databind_deser_DeserializerCache,328,22,362,34,0,0,24,2,0,0,357,29,1,5,24,2,0,0,361,33,1,1,24,2,0,0
JacksonDatabind/103,src_main_java_com_fasterxml_jackson_databind_deser_SettableAnyProperty,157,27,190,33,0,0,29,2,0,0,188,31,2,2,29,2,0,0,186,29,2,4,29,2,0,0
JacksonDatabind/103,src_main_java_com_fasterxml_jackson_databind_deser_SettableBeanProperty,593,88,635,42,0,0,91,3,0,0,629,36,2,6,91,3,0,0,631,38,2,4,91,3,0,0
JacksonDatabind/103,src_main_java_com_fasterxml_jackson_databind_deser_std_StdDeserializer,954,66,975,21,0,0,68,2,0,0,970,16,1,5,68,2,0,0,974,20,1,1,68,2,0,0
JacksonDatabind/103,src_main_java_com_fasterxml_jackson_databind_deser_std_StdKeyDeserializer,369,62,411,42,0,0,65,3,0,0,406,37,2,5,65,3,0,0,408,39,1,3,65,3,0,0
JacksonDatabind/103,src_main_java_com_fasterxml_jackson_databind_deser_std_StdValueInstantiator,436,62,456,20,0,0,64,2,0,0,452,16,1,4,64,2,0,0,454,18,0,2,64,2,0,0
JacksonDatabind/103,src_main_java_com_fasterxml_jackson_databind_introspect_BasicBeanDescription,526,53,556,30,0,0,55,2,0,0,552,26,1,4,55,2,0,0,554,28,0,2,55,2,0,0
JacksonDatabind/103,src_main_java_com_fasterxml_jackson_databind_ser_DefaultSerializerProvider,404,33,445,41,0,0,36,3,0,0,439,35,2,6,36,3,0,0,442,38,1,3,36,3,0,0
JacksonDatabind/103,src_main_java_com_fasterxml_jackson_databind_ser_PropertyBuilder,97,14,215,118,0,0,16,2,0,0,210,113,2,5,16,2,0,0,213,116,2,2,16,2,0,0
JacksonDatabind/103,src_main_java_com_fasterxml_jackson_databind_util_ClassUtil,1024,94,1028,4,0,0,95,1,0,0,1024,0,0,4,95,1,0,0,1028,4,0,0,95,1,0,0
JacksonDatabind/104,src_main_java_com_fasterxml_jackson_databind_util_StdDateFormat,470,57,546,76,0,0,60,3,0,0,543,73,0,3,60,3,0,0,546,76,0,0,60,3,0,0
JacksonDatabind/105,src_main_java_com_fasterxml_jackson_databind_deser_std_JdkDeserializers,0,1,37,37,0,0,3,2,0,0,37,37,0,0,3,2,0,0,37,37,0,0,3,2,0,0
JacksonDatabind/106,src_main_java_com_fasterxml_jackson_databind_node_TreeTraversingParser,328,37,348,20,0,0,40,3,0,0,345,17,0,3,40,3,0,0,348,20,0,0,40,3,0,0
JacksonDatabind/107,src_main_java_com_fasterxml_jackson_databind_jsontype_impl_TypeDeserializerBase,155,24,192,37,0,0,26,2,0,0,192,37,0,0,26,2,0,0,192,37,0,0,26,2,0,0
JacksonDatabind/108,src_main_java_com_fasterxml_jackson_databind_ObjectReader,1307,139,1324,17,0,0,141,2,0,0,1321,14,0,3,141,2,0,0,1324,17,0,0,141,2,0,0
JacksonDatabind/109,src_main_java_com_fasterxml_jackson_databind_ser_std_NumberSerializer,60,5,81,21,0,0,8,3,0,0,81,21,4,0,7,2,0,1,81,21,2,0,7,2,1,1
JacksonDatabind/109,src_main_java_com_fasterxml_jackson_databind_ser_std_NumberSerializers,191,31,216,25,0,0,34,3,0,0,216,25,0,0,34,3,0,0,216,25,0,0,34,3,0,0
JacksonDatabind/11,src_main_java_com_fasterxml_jackson_databind_type_TypeFactory,711,67,734,23,0,0,69,2,0,0,730,19,1,4,69,2,0,0,733,22,0,1,69,2,0,0
JacksonDatabind/110,src_main_java_com_fasterxml_jackson_databind_deser_impl_JavaUtilCollectionsDeserializers,94,24,136,42,0,0,26,2,0,0,136,42,0,0,26,2,0,0,136,42,0,0,26,2,0,0
JacksonDatabind/111,src_main_java_com_fasterxml_jackson_databind_deser_CreatorProperty,199,28,214,15,0,0,30,2,0,0,213,14,1,1,30,2,0,0,213,14,1,1,30,2,0,0
JacksonDatabind/111,src_main_java_com_fasterxml_jackson_databind_deser_impl_FieldProperty,174,18,190,16,0,0,20,2,0,0,189,15,1,1,20,2,0,0,189,15,1,1,20,2,0,0
JacksonDatabind/111,src_main_java_com_fasterxml_jackson_databind_deser_impl_MethodProperty,174,18,190,16,0,0,20,2,0,0,189,15,1,1,20,2,0,0,189,15,1,1,20,2,0,0
JacksonDatabind/111,src_main_java_com_fasterxml_jackson_databind_deser_impl_ObjectIdReferenceProperty,143,20,158,15,0,0,22,2,0,0,157,14,1,1,22,2,0,0,157,14,1,1,22,2,0,0
JacksonDatabind/111,src_main_java_com_fasterxml_jackson_databind_deser_impl_ObjectIdValueProperty,102,13,118,16,0,0,15,2,0,0,117,15,1,1,15,2,0,0,117,15,1,1,15,2,0,0
JacksonDatabind/111,src_main_java_com_fasterxml_jackson_databind_deser_impl_SetterlessProperty,122,15,138,16,0,0,17,2,0,0,137,15,1,1,17,2,0,0,137,15,1,1,17,2,0,0
JacksonDatabind/111,src_main_java_com_fasterxml_jackson_databind_deser_std_AtomicReferenceDeserializer,53,8,64,11,0,0,10,2,0,0,64,11,0,0,10,2,0,0,64,11,0,0,10,2,0,0
JacksonDatabind/112,src_main_java_com_fasterxml_jackson_databind_deser_std_StringCollectionDeserializer,174,15,212,38,0,0,17,2,0,0,204,30,5,8,17,2,0,0,208,34,5,4,17,2,0,0
JacksonDatabind/12,src_main_java_com_fasterxml_jackson_databind_deser_std_MapDeserializer,518,46,528,10,0,0,48,2,0,0,525,7,0,3,48,2,0,0,528,10,0,0,48,2,0,0
JacksonDatabind/13,src_main_java_com_fasterxml_jackson_databind_deser_DefaultDeserializationContext,206,23,248,42,0,0,25,2,0,0,244,38,0,4,25,2,0,0,248,42,0,0,25,2,0,0
JacksonDatabind/13,src_main_java_com_fasterxml_jackson_databind_deser_impl_ObjectIdValueProperty,89,13,111,22,0,0,15,2,0,0,111,22,0,0,15,2,0,0,111,22,0,0,15,2,0,0
JacksonDatabind/14,src_main_java_com_fasterxml_jackson_databind_ObjectReader,1171,122,1199,28,0,0,124,2,0,0,1196,25,0,3,124,2,0,0,1199,28,0,0,124,2,0,0
JacksonDatabind/15,src_main_java_com_fasterxml_jackson_databind_JavaType,310,51,317,7,0,0,52,1,0,0,313,3,0,4,52,1,0,0,317,7,0,0,52,1,0,0
JacksonDatabind/15,src_main_java_com_fasterxml_jackson_databind_ser_BeanSerializerFactory,415,21,459,44,0,0,23,2,0,0,456,41,0,3,23,2,0,0,459,44,0,0,23,2,0,0
JacksonDatabind/15,src_main_java_com_fasterxml_jackson_databind_ser_std_BeanSerializerBase,576,34,603,27,0,0,36,2,0,0,599,23,0,4,36,2,0,0,603,27,0,0,36,2,0,0
JacksonDatabind/15,src_main_java_com_fasterxml_jackson_databind_ser_std_StdDelegatingSerializer,94,13,176,82,0,1,20,7,0,0,174,80,3,3,20,7,0,0,173,79,3,4,20,7,0,0
JacksonDatabind/15,src_main_java_com_fasterxml_jackson_databind_ser_std_StdSerializer,164,17,193,29,0,0,19,2,0,0,193,29,0,0,19,2,0,0,193,29,0,0,19,2,0,0
JacksonDatabind/16,src_main_java_com_fasterxml_jackson_databind_introspect_AnnotationMap,80,10,99,19,0,0,12,2,0,0,99,19,0,0,12,2,0,0,99,19,0,0,12,2,0,0
JacksonDatabind/17,src_main_java_com_fasterxml_jackson_databind_ObjectMapper,2024,231,2057,33,0,0,236,5,0,0,2054,30,0,3,236,5,0,0,2057,33,0,0,236,5,0,0
JacksonDatabind/19,src_main_java_com_fasterxml_jackson_databind_type_TypeFactory,758,68,777,19,0,0,70,2,0,0,773,15,0,4,70,2,0,0,777,19,0,0,70,2,0,0
JacksonDatabind/2,src_main_java_com_fasterxml_jackson_databind_util_TokenBuffer,1562,161,1583,21,0,0,164,3,0,0,1571,9,2,12,162,1,0,2,1580,18,2,3,164,3,0,0
JacksonDatabind/20,src_main_java_com_fasterxml_jackson_databind_node_ObjectNode,535,61,551,16,0,0,63,2,0,0,548,13,0,3,63,2,0,0,551,16,0,0,63,2,0,0
JacksonDatabind/21,src_main_java_com_fasterxml_jackson_databind_introspect_JacksonAnnotationIntrospector,861,77,881,20,0,0,79,2,0,0,878,17,0,3,79,2,0,0,881,20,0,0,79,2,0,0
JacksonDatabind/22,src_main_java_com_fasterxml_jackson_databind_ser_BasicSerializerFactory,556,39,792,236,1,1,44,5,0,0,775,219,17,18,44,5,0,0,780,224,10,13,44,5,0,0
JacksonDatabind/22,src_main_java_com_fasterxml_jackson_databind_ser_BeanSerializerFactory,432,22,492,60,0,0,24,2,0,0,485,53,0,7,24,2,0,0,488,56,0,4,24,2,0,0
JacksonDatabind/23,src_main_java_com_fasterxml_jackson_databind_ser_std_NumberSerializers,164,26,231,67,0,0,36,10,0,0,231,67,0,0,36,10,0,0,231,67,0,0,36,10,0,0
JacksonDatabind/24,src_main_java_com_fasterxml_jackson_databind_cfg_BaseSettings,196,37,211,15,0,0,39,2,0,0,210,14,1,1,39,2,0,0,210,14,1,1,39,2,0,0
JacksonDatabind/25,src_main_java_com_fasterxml_jackson_databind_deser_BasicDeserializerFactory,1372,63,1453,81,0,0,65,2,0,0,1448,76,1,5,65,2,0,0,1452,80,0,1,65,2,0,0
JacksonDatabind/25,src_main_java_com_fasterxml_jackson_databind_deser_DeserializerCache,293,22,368,75,0,0,24,2,0,0,363,70,1,5,24,2,0,0,367,74,0,1,24,2,0,0
JacksonDatabind/25,src_main_java_com_fasterxml_jackson_databind_jsontype_impl_TypeDeserializerBase,150,22,183,33,0,0,24,2,0,0,182,32,1,1,24,2,0,0,182,32,0,1,24,2,0,0
JacksonDatabind/25,src_main_java_com_fasterxml_jackson_databind_module_SimpleAbstractTypeResolver,26,4,46,20,0,0,6,2,0,0,45,19,1,1,6,2,0,0,45,19,0,1,6,2,0,0
JacksonDatabind/26,src_main_java_com_fasterxml_jackson_databind_ser_BeanPropertyWriter,588,72,594,6,0,0,73,1,0,0,591,3,0,3,73,1,0,0,594,6,0,0,73,1,0,0
JacksonDatabind/27,src_main_java_com_fasterxml_jackson_databind_deser_BeanDeserializer,631,25,705,74,0,0,27,2,0,0,702,71,0,3,27,2,0,0,705,74,0,0,27,2,0,0
JacksonDatabind/29,src_main_java_com_fasterxml_jackson_databind_deser_impl_ExternalTypeHandler,228,26,274,46,0,0,29,3,0,0,271,43,0,3,29,3,0,0,274,46,0,0,29,3,0,0
JacksonDatabind/3,src_main_java_com_fasterxml_jackson_databind_deser_std_StringArrayDeserializer,62,8,126,64,1,2,11,3,0,0,128,66,0,0,11,3,0,0,126,64,0,2,11,3,0,0
JacksonDatabind/30,src_main_java_com_fasterxml_jackson_databind_ObjectMapper,2168,256,2231,63,0,0,259,3,0,0,2228,60,0,3,259,3,0,0,2231,63,0,0,259,3,0,0
JacksonDatabind/30,src_main_java_com_fasterxml_jackson_databind_util_TokenBuffer,1505,161,1597,92,0,0,165,4,0,0,1594,89,0,3,165,4,0,0,1597,92,0,0,165,4,0,0
JacksonDatabind/31,src_main_java_com_fasterxml_jackson_databind_util_TokenBuffer,1412,148,1627,215,0,0,167,19,0,0,1604,192,20,23,165,17,2,2,1607,195,20,20,165,17,2,2
JacksonDatabind/32,src_main_java_com_fasterxml_jackson_databind_deser_std_UntypedObjectDeserializer,384,27,499,115,0,0,33,6,0,0,495,111,1,4,33,6,0,0,499,115,0,0,33,6,0,0
JacksonDatabind/33,src_main_java_com_fasterxml_jackson_databind_introspect_JacksonAnnotationIntrospector,911,78,938,27,0,0,80,2,0,0,935,24,0,3,80,2,0,0,938,27,0,0,80,2,0,0
JacksonDatabind/34,src_main_java_com_fasterxml_jackson_databind_ser_std_NumberSerializer,46,5,70,24,0,0,7,2,0,0,70,24,0,0,7,2,0,0,70,24,0,0,7,2,0,0
JacksonDatabind/35,src_main_java_com_fasterxml_jackson_databind_jsontype_impl_AsWrapperTypeDeserializer,64,9,105,41,3,3,11,2,0,0,105,41,3,3,11,2,0,0,105,41,2,3,11,2,0,0
JacksonDatabind/36,src_main_java_com_fasterxml_jackson_databind_util_StdDateFormat,345,41,391,46,0,0,44,3,0,0,388,43,0,3,44,3,0,0,391,46,0,0,44,3,0,0
JacksonDatabind/37,src_main_java_com_fasterxml_jackson_databind_type_SimpleType,198,21,212,14,0,0,23,2,0,0,212,14,0,0,23,2,0,0,212,14,0,0,23,2,0,0
JacksonDatabind/38,src_main_java_com_fasterxml_jackson_databind_type_CollectionType,100,13,114,14,0,0,15,2,0,0,114,14,0,0,15,2,0,0,114,14,0,0,15,2,0,0
JacksonDatabind/38,src_main_java_com_fasterxml_jackson_databind_type_MapType,127,16,142,15,0,0,18,2,0,0,142,15,0,0,18,2,0,0,142,15,0,0,18,2,0,0
JacksonDatabind/38,src_main_java_com_fasterxml_jackson_databind_type_SimpleType,184,20,215,31,0,0,23,3,0,0,214,30,8,1,23,3,0,0,214,30,0,1,23,3,0,0
JacksonDatabind/39,src_main_java_com_fasterxml_jackson_databind_deser_std_NullifyingDeserializer,20,4,33,13,0,0,6,2,0,0,32,12,1,1,6,2,0,0,32,12,1,1,6,2,0,0
JacksonDatabind/4,src_main_java_com_fasterxml_jackson_databind_deser_std_StringArrayDeserializer,62,8,128,66,0,0,11,3,0,0,128,66,0,0,11,3,0,0,128,66,0,0,11,3,0,0
JacksonDatabind/40,src_main_java_com_fasterxml_jackson_databind_deser_std_NumberDeserializers,526,74,539,13,0,0,76,2,0,0,536,10,0,3,76,2,0,0,539,13,0,0,76,2,0,0
JacksonDatabind/42,src_main_java_com_fasterxml_jackson_databind_deser_std_FromStringDeserializer,205,23,224,19,0,0,26,3,0,0,220,15,0,4,26,3,0,0,224,19,0,0,26,3,0,0
JacksonDatabind/43,src_main_java_com_fasterxml_jackson_databind_deser_impl_ObjectIdValueProperty,81,12,106,25,0,0,14,2,0,0,105,24,0,1,14,2,0,0,106,25,0,0,14,2,0,0
JacksonDatabind/44,src_main_java_com_fasterxml_jackson_databind_type_SimpleType,214,22,229,15,0,0,24,2,0,0,227,13,2,2,24,2,0,0,227,13,2,2,24,2,0,0
JacksonDatabind/45,src_main_java_com_fasterxml_jackson_databind_ser_std_DateTimeSerializerBase,90,12,124,34,3,1,14,2,0,0,125,35,2,0,14,2,0,0,124,34,2,1,14,2,0,0
JacksonDatabind/46,src_main_java_com_fasterxml_jackson_databind_type_ReferenceType,153,20,168,15,0,0,22,2,0,0,168,15,0,0,22,2,0,0,168,15,0,0,22,2,0,0
JacksonDatabind/47,src_main_java_com_fasterxml_jackson_databind_AnnotationIntrospector,584,88,662,78,0,0,90,2,0,0,657,73,1,5,90,2,0,0,661,77,1,1,90,2,0,0
JacksonDatabind/48,src_main_java_com_fasterxml_jackson_databind_DeserializationConfig,656,78,676,20,0,0,80,2,0,0,672,16,0,4,80,2,0,0,676,20,0,0,80,2,0,0
JacksonDatabind/48,src_main_java_com_fasterxml_jackson_databind_SerializationConfig,679,81,699,20,0,0,83,2,0,0,695,16,0,4,83,2,0,0,699,20,0,0,83,2,0,0
JacksonDatabind/49,src_main_java_com_fasterxml_jackson_databind_ser_impl_WritableObjectId,40,6,51,11,0,0,8,2,0,0,50,10,1,1,8,2,0,0,50,10,1,1,8,2,0,0
JacksonDatabind/5,src_main_java_com_fasterxml_jackson_databind_introspect_AnnotatedClass,721,64,750,29,0,0,66,2,0,0,742,21,4,8,66,2,0,0,746,25,4,4,66,2,0,0
JacksonDatabind/50,src_main_java_com_fasterxml_jackson_databind_deser_BeanDeserializer,647,29,747,100,0,0,32,3,0,0,743,96,1,4,32,3,0,0,745,98,1,2,32,3,0,0
JacksonDatabind/51,src_main_java_com_fasterxml_jackson_databind_jsontype_impl_TypeDeserializerBase,147,22,182,35,0,0,24,2,0,0,181,34,1,1,24,2,0,0,181,34,1,1,24,2,0,0
JacksonDatabind/52,src_main_java_com_fasterxml_jackson_databind_deser_BeanDeserializerBase,1007,83,1108,101,0,0,85,2,0,0,1104,97,0,4,85,2,0,0,1108,101,0,0,85,2,0,0
JacksonDatabind/52,src_main_java_com_fasterxml_jackson_databind_deser_impl_ExternalTypeHandler,285,29,298,13,0,0,32,3,0,0,295,10,0,3,32,3,0,0,298,13,0,0,32,3,0,0
JacksonDatabind/53,src_main_java_com_fasterxml_jackson_databind_type_TypeBindings,288,39,311,23,0,0,41,2,0,0,308,20,0,3,41,2,0,0,311,23,0,0,41,2,0,0
JacksonDatabind/53,src_main_java_com_fasterxml_jackson_databind_type_TypeFactory,717,86,851,134,0,3,90,4,0,0,839,122,12,15,90,4,0,0,841,124,9,13,90,4,0,0
JacksonDatabind/54,src_main_java_com_fasterxml_jackson_databind_ser_PropertyBuilder,106,13,188,82,0,0,15,2,0,0,188,82,0,0,15,2,0,0,188,82,0,0,15,2,0,0
JacksonDatabind/55,src_main_java_com_fasterxml_jackson_databind_ser_std_StdKeySerializers,139,23,160,21,4,1,25,2,0,0,161,22,1,0,25,2,0,0,157,18,1,4,25,2,0,0
JacksonDatabind/56,src_main_java_com_fasterxml_jackson_databind_deser_std_FromStringDeserializer,153,23,229,76,0,0,26,3,0,0,223,70,4,6,26,3,0,0,225,72,0,4,26,3,0,0
JacksonDatabind/57,src_main_java_com_fasterxml_jackson_databind_ObjectReader,1244,133,1264,20,0,0,135,2,0,0,1261,17,0,3,135,2,0,0,1264,20,0,0,135,2,0,0
JacksonDatabind/58,src_main_java_com_fasterxml_jackson_databind_deser_BeanDeserializerFactory,491,23,535,44,0,0,25,2,0,0,531,40,1,4,25,2,0,0,534,43,1,1,25,2,0,0
JacksonDatabind/59,src_main_java_com_fasterxml_jackson_databind_JavaType,348,61,355,7,0,0,62,1,0,0,351,3,0,4,62,1,0,0,355,7,0,0,62,1,0,0
JacksonDatabind/59,src_main_java_com_fasterxml_jackson_databind_type_CollectionLikeType,215,27,219,4,0,0,28,1,0,0,219,4,0,0,28,1,0,0,219,4,0,0,28,1,0,0
JacksonDatabind/59,src_main_java_com_fasterxml_jackson_databind_type_MapLikeType,240,31,244,4,0,0,32,1,0,0,244,4,0,0,32,1,0,0,244,4,0,0,32,1,0,0
JacksonDatabind/59,src_main_java_com_fasterxml_jackson_databind_type_TypeFactory,827,90,889,62,0,0,92,2,0,0,885,58,0,4,92,2,0,0,889,62,0,0,92,2,0,0
JacksonDatabind/60,src_main_java_com_fasterxml_jackson_databind_ser_std_JsonValueSerializer,185,15,232,47,0,0,17,2,0,0,228,43,1,4,17,2,0,0,230,45,1,2,17,2,0,0
JacksonDatabind/61,src_main_java_com_fasterxml_jackson_databind_ObjectMapper,2195,259,2232,37,0,0,264,5,0,0,2229,34,0,3,264,5,0,0,2232,37,0,0,264,5,0,0
JacksonDatabind/61,src_main_java_com_fasterxml_jackson_databind_jsontype_impl_StdTypeResolverBuilder,102,17,162,60,0,0,20,3,0,0,162,60,0,0,20,3,0,0,162,60,0,0,20,3,0,0
JacksonDatabind/62,src_main_java_com_fasterxml_jackson_databind_deser_std_CollectionDeserializer,256,32,292,36,0,0,34,2,0,0,289,33,0,3,34,2,0,0,292,36,0,0,34,2,0,0
JacksonDatabind/63,src_main_java_com_fasterxml_jackson_databind_JsonMappingException,344,52,381,37,2,0,55,3,0,0,378,34,11,3,55,3,0,0,381,37,2,0,55,3,0,0
JacksonDatabind/65,src_main_java_com_fasterxml_jackson_databind_deser_std_StdKeyDeserializer,351,60,381,30,0,0,62,2,0,0,378,27,0,3,62,2,0,0,381,30,0,0,62,2,0,0
JacksonDatabind/65,src_main_java_com_fasterxml_jackson_databind_introspect_BasicBeanDescription,464,47,511,47,0,0,50,3,0,0,507,43,1,4,50,3,0,0,510,46,1,1,50,3,0,0
JacksonDatabind/66,src_main_java_com_fasterxml_jackson_databind_deser_std_StdKeyDeserializer,336,53,381,45,3,0,62,9,0,0,378,42,0,3,62,9,0,0,380,44,4,1,62,9,0,0
JacksonDatabind/67,src_main_java_com_fasterxml_jackson_databind_deser_BasicDeserializerFactory,1425,67,1479,54,0,0,69,2,0,0,1475,50,0,4,69,2,0,0,1479,54,0,0,69,2,0,0
JacksonDatabind/69,src_main_java_com_fasterxml_jackson_databind_deser_impl_CreatorCollector,234,52,308,74,0,0,56,4,0,0,305,71,0,3,56,4,0,0,308,74,0,0,56,4,0,0
JacksonDatabind/7,src_main_java_com_fasterxml_jackson_databind_util_TokenBuffer,1589,162,1602,13,0,0,164,2,0,0,1595,6,2,7,163,1,0,1,1600,11,2,2,164,2,0,0
JacksonDatabind/70,src_main_java_com_fasterxml_jackson_databind_deser_impl_BeanPropertyMap,402,33,431,29,0,0,35,2,0,0,428,26,2,3,35,2,0,0,431,29,0,0,35,2,0,0
JacksonDatabind/71,src_main_java_com_fasterxml_jackson_databind_deser_std_StdKeyDeserializer,297,60,367,70,0,0,62,2,0,0,364,67,0,3,62,2,0,0,367,70,0,0,62,2,0,0
JacksonDatabind/72,src_main_java_com_fasterxml_jackson_databind_deser_impl_InnerClassProperty,143,20,148,5,0,0,21,1,0,0,148,5,0,0,21,1,0,0,148,5,0,0,21,1,0,0
JacksonDatabind/73,src_main_java_com_fasterxml_jackson_databind_introspect_POJOPropertiesCollector,729,54,743,14,0,0,56,2,0,0,740,11,0,3,56,2,0,0,743,14,0,0,56,2,0,0
JacksonDatabind/73,src_main_java_com_fasterxml_jackson_databind_introspect_POJOPropertyBuilder,1052,112,1088,36,0,0,114,2,0,0,1085,33,0,3,114,2,0,0,1088,36,0,0,114,2,0,0
JacksonDatabind/74,src_main_java_com_fasterxml_jackson_databind_jsontype_impl_AsPropertyTypeDeserializer,112,10,143,31,0,0,12,2,0,0,143,31,0,0,12,2,0,0,143,31,0,0,12,2,0,0
JacksonDatabind/75,src_main_java_com_fasterxml_jackson_databind_ser_std_EnumSerializer,96,10,153,57,0,0,14,4,0,0,153,57,0,0,14,4,0,0,152,56,1,1,14,4,0,0
JacksonDatabind/76,src_main_java_com_fasterxml_jackson_databind_deser_BuilderBasedDeserializer,544,27,595,51,0,0,29,2,0,0,591,47,1,4,29,2,0,0,592,48,1,3,29,2,0,0
JacksonDatabind/77,src_main_java_com_fasterxml_jackson_databind_deser_BeanDeserializerFactory,502,23,539,37,0,0,25,2,0,0,536,34,0,3,25,2,0,0,539,37,0,0,25,2,0,0
JacksonDatabind/78,src_main_java_com_fasterxml_jackson_databind_deser_BeanDeserializerFactory,523,23,560,37,0,0,25,2,0,0,557,34,0,3,25,2,0,0,560,37,0,0,25,2,0,0
JacksonDatabind/79,src_main_java_com_fasterxml_jackson_databind_introspect_JacksonAnnotationIntrospector,1087,93,1112,25,4,1,95,2,0,0,1108,21,2,5,95,2,0,0,1109,22,1,4,95,2,0,0
JacksonDatabind/79,src_main_java_com_fasterxml_jackson_databind_introspect_ObjectIdInfo,80,16,91,11,0,0,18,2,0,0,91,11,0,0,18,2,0,0,91,11,0,0,18,2,0,0
JacksonDatabind/79,src_main_java_com_fasterxml_jackson_databind_ser_std_BeanSerializerBase,507,35,618,111,0,0,37,2,0,0,613,106,1,5,37,2,0,0,616,109,1,2,37,2,0,0
JacksonDatabind/8,src_main_java_com_fasterxml_jackson_databind_deser_impl_CreatorCollector,259,49,286,27,2,1,51,2,0,0,284,25,0,3,51,2,0,0,287,28,0,0,51,2,0,0
JacksonDatabind/80,src_main_java_com_fasterxml_jackson_databind_jsontype_impl_StdSubtypeResolver,146,10,212,66,0,0,13,3,0,0,209,63,0,3,13,3,0,0,212,66,0,0,13,3,0,0
JacksonDatabind/81,src_main_java_com_fasterxml_jackson_databind_introspect_JacksonAnnotationIntrospector,1089,94,1229,140,0,0,97,3,0,0,1226,137,0,3,97,3,0,0,1229,140,0,0,97,3,0,0
JacksonDatabind/82,src_main_java_com_fasterxml_jackson_databind_deser_BeanDeserializerFactory,466,26,586,120,0,0,28,2,0,0,583,117,0,3,28,2,0,0,586,120,0,0,28,2,0,0
JacksonDatabind/83,src_main_java_com_fasterxml_jackson_databind_deser_std_FromStringDeserializer,188,26,243,55,0,0,28,2,0,0,238,50,1,5,28,2,0,0,242,54,1,1,28,2,0,0
JacksonDatabind/84,src_main_java_com_fasterxml_jackson_databind_type_ResolvedRecursiveType,125,18,129,4,0,0,19,1,0,0,129,4,0,0,19,1,0,0,129,4,0,0,19,1,0,0
JacksonDatabind/86,src_main_java_com_fasterxml_jackson_databind_type_ResolvedRecursiveType,125,18,129,4,0,0,19,1,0,0,129,4,0,0,19,1,0,0,129,4,0,0,19,1,0,0
JacksonDatabind/87,src_main_java_com_fasterxml_jackson_databind_util_StdDateFormat,293,43,422,129,0,0,47,4,0,0,419,126,2,3,46,3,0,1,416,123,1,6,47,4,0,0
JacksonDatabind/88,src_main_java_com_fasterxml_jackson_databind_jsontype_impl_ClassNameIdResolver,89,8,118,29,0,0,10,2,0,0,118,29,0,0,10,2,0,0,118,29,0,0,10,2,0,0
JacksonDatabind/89,src_main_java_com_fasterxml_jackson_databind_deser_BeanDeserializerFactory,568,27,586,18,0,0,28,1,0,0,583,15,0,3,28,1,0,0,586,18,0,0,28,1,0,0
JacksonDatabind/90,src_main_java_com_fasterxml_jackson_databind_deser_ValueInstantiator,231,36,240,9,0,0,38,2,0,0,240,9,0,0,38,2,0,0,240,9,0,0,38,2,0,0
JacksonDatabind/90,src_main_java_com_fasterxml_jackson_databind_deser_std_StdValueInstantiator,442,62,448,6,0,0,63,1,0,0,445,3,0,3,63,1,0,0,448,6,0,0,63,1,0,0
JacksonDatabind/91,src_main_java_com_fasterxml_jackson_databind_deser_DeserializerCache,334,22,352,18,0,0,24,2,0,0,347,13,0,5,24,2,0,0,351,17,0,1,24,2,0,0
JacksonDatabind/92,src_main_java_com_fasterxml_jackson_databind_deser_BeanDeserializerFactory,547,27,565,18,0,0,28,1,0,0,562,15,0,3,28,1,0,0,565,18,0,0,28,1,0,0
JacksonDatabind/93,src_main_java_com_fasterxml_jackson_databind_jsontype_impl_SubTypeValidator,9,6,59,50,0,0,8,2,0,0,59,50,0,0,8,2,0,0,59,50,0,0,8,2,0,0
JacksonDatabind/94,src_main_java_com_fasterxml_jackson_databind_jsontype_impl_SubTypeValidator,9,6,58,49,0,0,8,2,0,0,58,49,0,0,8,2,0,0,58,49,0,0,8,2,0,0
JacksonDatabind/95,src_main_java_com_fasterxml_jackson_databind_type_TypeFactory,876,91,942,66,2,2,94,3,0,0,940,64,2,4,94,3,0,0,944,68,0,0,94,3,0,0
JacksonDatabind/95,src_main_java_com_fasterxml_jackson_databind_type_TypeParser,111,18,135,24,0,0,20,2,0,0,135,24,0,0,20,2,0,0,135,24,0,0,20,2,0,0
JacksonDatabind/96,src_main_java_com_fasterxml_jackson_databind_deser_BasicDeserializerFactory,1535,69,1595,60,0,0,71,2,0,0,1591,56,0,4,71,2,0,0,1595,60,0,0,71,2,0,0
JacksonDatabind/97,src_main_java_com_fasterxml_jackson_databind_node_POJONode,126,16,146,20,0,3,18,2,0,0,148,22,1,1,18,2,0,0,145,19,0,4,18,2,0,0
JacksonDatabind/98,src_main_java_com_fasterxml_jackson_databind_deser_impl_ExternalTypeHandler,341,36,391,50,0,0,38,2,0,0,387,46,1,4,38,2,0,0,390,49,1,1,38,2,0,0
JacksonDatabind/99,src_main_java_com_fasterxml_jackson_databind_type_ReferenceType,209,26,223,14,0,0,28,2,0,0,223,14,0,0,28,2,0,0,223,14,0,0,28,2,0,0
JacksonXml/1,src_main_java_com_fasterxml_jackson_dataformat_xml_deser_FromXmlParser,549,68,657,108,0,0,70,2,0,0,652,103,2,5,70,2,0,0,654,105,0,3,70,2,0,0
JacksonXml/2,src_main_java_com_fasterxml_jackson_dataformat_xml_deser_XmlTokenStream,292,44,333,41,0,0,46,2,0,0,329,37,0,4,46,2,0,0,333,41,0,0,46,2,0,0
JacksonXml/3,src_main_java_com_fasterxml_jackson_dataformat_xml_deser_FromXmlParser,577,68,661,84,0,0,70,2,0,0,658,81,0,3,70,2,0,0,660,83,0,1,70,2,0,0
JacksonXml/4,src_main_java_com_fasterxml_jackson_dataformat_xml_ser_XmlSerializerProvider,213,13,228,15,0,0,15,2,0,0,227,14,1,1,15,2,0,0,227,14,1,1,15,2,0,0
JacksonXml/5,src_main_java_com_fasterxml_jackson_dataformat_xml_ser_XmlSerializerProvider,191,15,201,10,0,0,17,2,0,0,201,10,0,0,17,2,0,0,201,10,0,0,17,2,0,0
JacksonXml/6,src_main_java_com_fasterxml_jackson_dataformat_xml_ser_ToXmlGenerator,1020,84,1025,5,0,0,85,1,0,0,1021,1,0,4,85,1,0,0,1025,5,0,0,85,1,0,0
Jsoup/1,src_main_java_org_jsoup_nodes_Document,85,11,109,24,0,0,13,2,0,0,109,24,0,0,13,2,0,0,109,24,0,0,13,2,0,0
Jsoup/10,src_main_java_org_jsoup_nodes_Node,339,52,368,29,0,0,54,2,0,0,364,25,0,4,54,2,0,0,368,29,0,0,54,2,0,0
Jsoup/11,src_main_java_org_jsoup_select_Selector,295,31,373,78,0,0,34,3,0,0,370,75,0,3,34,3,0,0,373,78,0,0,34,3,0,0
Jsoup/12,src_main_java_org_jsoup_select_Selector,384,34,406,22,0,0,36,2,0,0,403,19,3,3,36,2,0,0,405,21,3,1,36,2,0,0
Jsoup/13,src_main_java_org_jsoup_nodes_Node,433,59,445,12,0,0,61,2,0,0,437,4,0,8,60,1,0,1,445,12,0,0,61,2,0,0
Jsoup/14,src_main_java_org_jsoup_parser_Tokeniser,200,39,202,2,0,0,40,1,0,0,202,2,0,0,40,1,0,0,202,2,0,0,40,1,0,0
Jsoup/14,src_main_java_org_jsoup_parser_TokeniserState,1711,72,1723,12,0,0,74,2,0,0,1723,12,0,0,74,2,0,0,1723,12,0,0,74,2,0,0
Jsoup/15,src_main_java_org_jsoup_parser_TreeBuilderState,1075,41,1587,512,0,0,43,2,0,0,1582,507,1,5,43,2,0,0,1587,512,0,0,43,2,0,0
Jsoup/16,src_main_java_org_jsoup_nodes_DocumentType,13,2,43,30,0,0,5,3,0,0,43,30,0,0,5,3,0,0,43,30,0,0,5,3,0,0
Jsoup/17,src_main_java_org_jsoup_parser_TreeBuilderState,1587,41,1587,0,0,0,43,2,0,0,1587,0,2,0,42,1,0,1,1587,0,0,0,43,2,0,0
Jsoup/18,src_main_java_org_jsoup_parser_CharacterReader,184,30,199,15,0,0,33,3,0,0,199,15,0,0,33,3,0,0,199,15,0,0,33,3,0,0
Jsoup/19,src_main_java_org_jsoup_safety_Whitelist,269,37,289,20,0,0,39,2,0,0,286,17,0,3,39,2,0,0,289,20,0,0,39,2,0,0
Jsoup/2,src_main_java_org_jsoup_parser_Parser,217,26,262,45,0,0,28,2,0,0,259,42,0,3,28,2,0,0,262,45,0,0,28,2,0,0
Jsoup/20,src_main_java_org_jsoup_helper_DataUtil,73,9,108,35,0,0,11,2,0,0,108,35,0,0,11,2,0,0,108,35,0,0,11,2,0,0
Jsoup/23,src_main_java_org_jsoup_parser_CharacterReader,197,32,199,2,0,0,33,1,0,0,199,2,0,0,33,1,0,0,199,2,0,0,33,1,0,0
Jsoup/23,src_main_java_org_jsoup_parser_Tokeniser,139,36,202,63,0,0,38,2,0,0,202,63,0,0,38,2,0,0,202,63,0,0,38,2,0,0
Jsoup/24,src_main_java_org_jsoup_parser_TokeniserState,1704,75,1738,34,0,0,77,2,0,0,1738,34,0,0,77,2,0,0,1738,34,0,0,77,2,0,0
Jsoup/25,src_main_java_org_jsoup_parser_Tag,142,31,174,32,0,0,33,2,0,0,174,32,0,0,33,2,0,0,174,32,0,0,33,2,0,0
Jsoup/26,src_main_java_org_jsoup_safety_Cleaner,72,9,84,12,0,0,11,2,0,0,84,12,0,0,11,2,0,0,84,12,0,0,11,2,0,0
Jsoup/27,src_main_java_org_jsoup_helper_DataUtil,95,9,112,17,0,0,11,2,0,0,112,17,0,0,11,2,0,0,112,17,0,0,11,2,0,0
Jsoup/28,src_main_java_org_jsoup_nodes_Entities,96,20,116,20,2,0,22,2,0,0,114,18,8,2,22,2,0,0,112,16,3,4,21,1,0,1
Jsoup/28,src_main_java_org_jsoup_parser_Parser,97,17,100,3,0,0,18,1,0,0,100,3,0,0,18,1,0,0,100,3,0,0,18,1,0,0
Jsoup/28,src_main_java_org_jsoup_parser_Tokeniser,141,36,196,55,0,1,38,2,0,0,195,54,6,2,38,2,0,0,195,54,4,2,38,2,0,0
Jsoup/29,src_main_java_org_jsoup_nodes_Document,254,39,265,11,0,0,41,2,0,0,262,8,0,3,41,2,0,0,265,11,3,0,41,2,0,0
Jsoup/3,src_main_java_org_jsoup_nodes_Element,518,65,573,55,0,0,69,4,0,0,570,52,2,3,69,4,0,0,573,55,0,0,69,4,0,0
Jsoup/3,src_main_java_org_jsoup_parser_Parser,195,24,265,70,0,0,28,4,0,0,262,67,0,3,28,4,0,0,265,70,0,0,28,4,0,0
Jsoup/3,src_main_java_org_jsoup_parser_Tag,181,32,320,139,0,0,35,3,0,0,317,136,0,3,35,3,0,0,320,139,0,0,35,3,0,0
Jsoup/31,src_main_java_org_jsoup_parser_Token,239,63,246,7,0,0,65,2,0,0,246,7,0,0,65,2,0,0,246,7,0,0,65,2,0,0
Jsoup/31,src_main_java_org_jsoup_parser_TokeniserState,1751,75,1761,10,0,0,77,2,0,0,1761,10,0,0,77,2,0,0,1761,10,0,0,77,2,0,0
Jsoup/31,src_main_java_org_jsoup_parser_XmlTreeBuilder,97,7,108,11,0,0,9,2,0,0,108,11,0,0,9,2,0,0,108,11,0,0,9,2,0,0
Jsoup/33,src_main_java_org_jsoup_parser_HtmlTreeBuilder,683,85,699,16,0,0,87,2,0,0,697,14,0,2,87,2,0,0,699,16,0,0,87,2,0,0
Jsoup/34,src_main_java_org_jsoup_parser_CharacterReader,236,34,258,22,0,0,36,2,0,0,256,20,0,2,36,2,0,0,258,22,0,0,36,2,0,0
Jsoup/35,src_main_java_org_jsoup_parser_HtmlTreeBuilderState,1076,41,1587,511,0,0,43,2,0,0,1582,506,0,5,43,2,0,0,1587,511,0,0,43,2,0,0
Jsoup/36,src_main_java_org_jsoup_helper_DataUtil,79,8,139,60,0,0,12,4,0,0,138,59,1,1,12,4,0,0,138,59,1,1,12,4,0,0
Jsoup/37,src_main_java_org_jsoup_nodes_Element,762,92,774,12,0,0,94,2,0,0,771,9,0,3,94,2,0,0,774,12,0,0,94,2,0,0
Jsoup/38,src_main_java_org_jsoup_parser_HtmlTreeBuilderState,1081,59,1593,512,0,0,61,2,0,0,1588,507,0,5,61,2,0,0,1593,512,0,0,61,2,0,0
Jsoup/39,src_main_java_org_jsoup_helper_DataUtil,103,10,159,56,0,0,12,2,0,0,159,56,0,0,12,2,0,0,159,56,0,0,12,2,0,0
Jsoup/4,src_main_java_org_jsoup_nodes_Entities,25,9,76,51,0,0,11,2,0,0,73,48,8,3,11,2,0,0,76,51,8,0,11,2,0,0
Jsoup/40,src_main_java_org_jsoup_nodes_DocumentType,28,3,43,15,0,0,5,2,0,0,43,15,0,0,5,2,0,0,43,15,0,0,5,2,0,0
Jsoup/41,src_main_java_org_jsoup_nodes_Element,780,92,798,18,0,0,94,2,0,0,795,15,1,3,94,2,0,0,798,18,0,0,94,2,0,0
Jsoup/42,src_main_java_org_jsoup_nodes_FormElement,35,6,75,40,0,0,8,2,0,0,75,40,0,0,8,2,0,0,75,40,0,0,8,2,0,0
Jsoup/43,src_main_java_org_jsoup_nodes_Element,780,93,802,22,0,0,95,2,0,0,799,19,0,3,95,2,0,0,800,20,0,2,95,2,0,0
Jsoup/44,src_main_java_org_jsoup_parser_TreeBuilder,52,15,76,24,0,0,19,4,0,0,76,24,0,0,19,4,0,0,76,24,0,0,19,4,0,0
Jsoup/45,src_main_java_org_jsoup_parser_HtmlTreeBuilder,626,97,690,64,1,1,99,2,0,0,687,61,4,4,99,2,0,0,690,64,3,1,99,2,0,0
Jsoup/46,src_main_java_org_jsoup_nodes_Entities,120,22,199,79,5,5,24,2,0,0,201,81,0,3,24,2,0,0,204,84,0,0,24,2,0,0
Jsoup/47,src_main_java_org_jsoup_nodes_Entities,120,22,202,82,3,3,24,2,0,0,202,82,0,3,24,2,0,0,205,85,0,0,24,2,0,0
Jsoup/48,src_main_java_org_jsoup_helper_HttpConnection,981,141,1015,34,0,0,146,5,0,0,1008,27,0,7,146,5,0,0,1013,32,0,2,146,5,0,0
Jsoup/49,src_main_java_org_jsoup_nodes_Node,499,68,518,19,0,0,70,2,0,0,514,15,0,4,70,2,0,0,518,19,0,0,70,2,0,0
Jsoup/5,src_main_java_org_jsoup_parser_Parser,248,28,281,33,0,0,30,2,0,0,278,30,0,3,30,2,0,0,281,33,0,0,30,2,0,0
Jsoup/50,src_main_java_org_jsoup_helper_DataUtil,138,17,188,50,2,0,19,2,0,0,184,46,0,4,19,2,0,0,188,50,0,0,19,2,0,0
Jsoup/51,src_main_java_org_jsoup_parser_CharacterReader,340,42,350,10,0,0,44,2,0,0,347,7,0,3,44,2,0,0,350,10,0,0,44,2,0,0
Jsoup/52,src_main_java_org_jsoup_helper_DataUtil,170,19,221,51,0,0,21,2,0,0,216,46,1,5,21,2,0,0,214,44,10,7,21,2,0,0
Jsoup/52,src_main_java_org_jsoup_nodes_XmlDeclaration,32,7,49,17,0,0,10,3,0,0,48,16,9,1,10,3,0,0,46,14,5,3,9,2,0,1
Jsoup/52,src_main_java_org_jsoup_parser_XmlTreeBuilder,102,8,119,17,0,0,10,2,0,0,119,17,5,0,10,2,0,0,119,17,1,0,10,2,0,0
Jsoup/53,src_main_java_org_jsoup_parser_TokenQueue,257,34,288,31,0,0,36,2,0,0,285,28,0,3,36,2,0,0,288,31,0,0,36,2,0,0
Jsoup/54,src_main_java_org_jsoup_helper_W3CDom,113,13,131,18,0,0,16,3,0,0,131,18,0,0,16,3,0,0,131,18,0,0,16,3,0,0
Jsoup/55,src_main_java_org_jsoup_parser_TokeniserState,1675,81,1699,24,0,0,83,2,0,0,1699,24,0,0,83,2,0,0,1699,24,0,0,83,2,0,0
Jsoup/56,src_main_java_org_jsoup_nodes_DocumentType,13,7,55,42,0,0,11,4,0,0,55,42,0,0,10,3,0,1,55,42,0,0,11,4,0,0
Jsoup/56,src_main_java_org_jsoup_parser_HtmlTreeBuilderState,1583,60,1606,23,0,0,62,2,0,0,1606,23,0,0,62,2,0,0,1606,23,0,0,62,2,0,0
Jsoup/56,src_main_java_org_jsoup_parser_Token,361,79,378,17,0,0,82,3,0,0,375,14,0,3,82,3,0,0,378,17,0,0,82,3,0,0
Jsoup/56,src_main_java_org_jsoup_parser_TokeniserState,1667,81,1700,33,0,0,83,2,0,0,1700,33,0,0,83,2,0,0,1700,33,0,0,83,2,0,0
Jsoup/56,src_main_java_org_jsoup_parser_XmlTreeBuilder,124,10,134,10,0,0,12,2,0,0,134,10,0,0,12,2,0,0,134,10,0,0,12,2,0,0
Jsoup/57,src_main_java_org_jsoup_nodes_Attributes,257,35,272,15,0,2,37,2,0,0,271,14,0,3,37,2,0,0,274,17,0,0,37,2,0,0
Jsoup/58,src_main_java_org_jsoup_Jsoup,134,15,147,13,0,0,17,2,0,0,147,13,0,0,17,2,0,0,146,12,0,1,17,2,0,0
Jsoup/58,src_main_java_org_jsoup_parser_Parser,130,22,133,3,0,0,23,1,0,0,133,3,0,0,23,1,0,0,133,3,0,0,23,1,0,0
Jsoup/58,src_main_java_org_jsoup_safety_Cleaner,106,16,119,13,0,0,18,2,0,0,118,12,1,1,18,2,0,0,117,11,2,2,18,2,0,0
Jsoup/59,src_main_java_org_jsoup_parser_Token,355,81,384,29,0,0,84,3,0,0,381,26,0,3,84,3,0,0,384,29,0,0,84,3,0,0
Jsoup/6,src_main_java_org_jsoup_nodes_Entities,25,9,73,48,4,2,11,2,0,0,71,46,2,4,11,2,0,0,73,48,3,2,11,2,0,0
Jsoup/60,src_main_java_org_jsoup_parser_TokenQueue,257,34,294,37,0,0,36,2,0,0,291,34,0,3,36,2,0,0,294,37,0,0,36,2,0,0
Jsoup/60,src_main_java_org_jsoup_select_QueryParser,313,27,324,11,0,0,29,2,0,0,320,7,1,4,29,2,0,0,323,10,1,1,29,2,0,0
Jsoup/61,src_main_java_org_jsoup_nodes_Element,811,96,851,40,0,0,98,2,0,0,848,37,0,3,98,2,0,0,851,40,0,0,98,2,0,0
Jsoup/62,src_main_java_org_jsoup_parser_HtmlTreeBuilderState,1583,60,1607,24,0,0,62,2,0,0,1607,24,0,0,62,2,0,0,1607,24,0,0,62,2,0,0
Jsoup/64,src_main_java_org_jsoup_parser_HtmlTreeBuilderState,1594,60,1605,11,0,0,62,2,0,0,1605,11,0,0,62,2,0,0,1605,11,0,0,62,2,0,0
Jsoup/65,src_main_java_org_jsoup_parser_HtmlTreeBuilder,693,96,705,12,0,0,99,3,0,0,694,1,0,11,97,1,0,2,697,4,0,8,97,1,0,2
Jsoup/65,src_main_java_org_jsoup_parser_HtmlTreeBuilderState,1490,57,1606,116,0,0,62,5,0,0,1606,116,0,0,62,5,0,0,1606,116,0,0,62,5,0,0
Jsoup/66,src_main_java_org_jsoup_nodes_Element,924,112,961,37,0,0,118,6,0,0,947,23,1,14,115,3,0,3,956,32,0,5,117,5,0,1
Jsoup/67,src_main_java_org_jsoup_parser_HtmlTreeBuilder,682,97,706,24,0,0,99,2,0,0,703,21,0,3,99,2,0,0,706,24,0,0,99,2,0,0
Jsoup/68,src_main_java_org_jsoup_parser_HtmlTreeBuilder,682,98,705,23,0,0,100,2,0,0,702,20,0,3,100,2,0,0,705,23,0,0,100,2,0,0
Jsoup/69,src_main_java_org_jsoup_nodes_FormElement,64,6,68,4,0,0,7,1,0,0,68,4,0,0,7,1,0,0,68,4,0,0,7,1,0,0
Jsoup/7,src_main_java_org_jsoup_nodes_Document,177,31,196,19,0,0,33,2,0,0,196,19,0,0,33,2,0,0,196,19,0,0,33,2,0,0
Jsoup/70,src_main_java_org_jsoup_nodes_Element,960,118,976,16,0,0,120,2,0,0,972,12,4,4,120,2,0,0,976,16,0,0,120,2,0,0
Jsoup/71,src_main_java_org_jsoup_select_Evaluator,908,153,912,4,0,0,154,1,0,0,908,0,0,4,154,1,0,0,912,4,0,0,154,1,0,0
Jsoup/71,src_main_java_org_jsoup_select_QueryParser,266,27,328,62,0,0,29,2,0,0,325,59,0,3,29,2,0,0,328,62,0,0,29,2,0,0
Jsoup/72,src_main_java_org_jsoup_parser_CharacterReader,378,50,412,34,0,0,52,2,0,0,408,30,0,4,52,2,0,0,412,34,0,0,52,2,0,0
Jsoup/73,src_main_java_org_jsoup_helper_W3CDom,53,9,135,82,1,1,16,7,0,0,135,82,1,1,16,7,0,0,133,80,1,3,16,7,0,0
Jsoup/74,src_main_java_org_jsoup_helper_StringUtil,172,18,201,29,0,0,20,2,0,0,197,25,0,4,20,2,0,0,201,29,0,0,20,2,0,0
Jsoup/75,src_main_java_org_jsoup_nodes_Attributes,354,56,377,23,0,0,58,2,0,0,374,20,0,3,58,2,0,0,375,21,1,2,58,2,0,0
Jsoup/76,src_main_java_org_jsoup_parser_HtmlTreeBuilderState,1095,60,1611,516,0,0,62,2,0,0,1606,511,0,5,62,2,0,0,1611,516,0,0,62,2,0,0
Jsoup/77,src_main_java_org_jsoup_parser_XmlTreeBuilder,114,11,141,27,0,0,13,2,0,0,141,27,0,0,13,2,0,0,141,27,0,0,13,2,0,0
Jsoup/78,src_main_java_org_jsoup_helper_DataUtil,161,23,227,66,0,0,25,2,0,0,223,62,0,4,25,2,0,0,227,66,0,0,25,2,0,0
Jsoup/79,src_main_java_org_jsoup_nodes_LeafNode,101,14,110,9,0,0,16,2,0,0,110,9,1,0,16,2,0,0,110,9,0,0,16,2,0,0
Jsoup/8,src_main_java_org_jsoup_nodes_Node,327,49,338,11,0,0,51,2,0,0,329,2,3,9,50,1,0,1,338,11,0,0,51,2,0,0
Jsoup/80,src_main_java_org_jsoup_parser_XmlTreeBuilder,120,11,140,20,0,0,13,2,0,0,140,20,0,0,13,2,0,0,140,20,0,0,13,2,0,0
Jsoup/81,src_main_java_org_jsoup_helper_DataUtil,161,23,236,75,0,0,25,2,0,0,232,71,0,4,25,2,0,0,236,75,0,0,25,2,0,0
Jsoup/82,src_main_java_org_jsoup_helper_DataUtil,138,21,219,81,0,0,23,2,0,0,215,77,0,4,23,2,0,0,219,81,0,0,23,2,0,0
Jsoup/84,src_main_java_org_jsoup_helper_W3CDom,90,13,136,46,0,0,16,3,0,0,136,46,0,0,16,3,0,0,136,46,0,0,16,3,0,0
Jsoup/86,src_main_java_org_jsoup_nodes_Comment,49,9,68,19,0,0,11,2,0,0,68,19,0,0,11,2,0,0,68,19,0,0,11,2,0,0
Jsoup/87,src_main_java_org_jsoup_nodes_Element,1019,123,1023,4,0,0,124,1,0,0,1020,1,0,3,124,1,0,0,1023,4,0,0,124,1,0,0
Jsoup/87,src_main_java_org_jsoup_parser_HtmlTreeBuilder,488,84,716,228,0,0,98,14,0,0,713,225,0,3,98,14,0,0,716,228,0,0,98,14,0,0
Jsoup/87,src_main_java_org_jsoup_parser_HtmlTreeBuilderState,635,54,1648,1013,0,1,66,12,0,0,1644,1009,1,5,66,12,0,0,1649,1014,0,0,66,12,0,0
Jsoup/87,src_main_java_org_jsoup_parser_Tag,154,37,199,45,0,0,39,2,0,0,196,42,0,3,39,2,0,0,199,45,0,0,39,2,0,0
Jsoup/88,src_main_java_org_jsoup_nodes_Attribute,172,23,181,9,0,0,25,2,0,0,181,9,0,0,25,2,0,0,180,8,0,1,25,2,0,0
Jsoup/89,src_main_java_org_jsoup_nodes_Attribute,164,23,182,18,0,0,25,2,0,0,181,17,0,1,25,2,0,0,181,17,0,1,25,2,0,0
Jsoup/9,src_main_java_org_jsoup_nodes_Entities,66,14,88,22,0,0,16,2,0,0,84,18,2,4,15,1,0,1,88,22,0,0,16,2,0,0
Jsoup/90,src_main_java_org_jsoup_helper_HttpConnection,1210,171,1256,46,0,0,174,3,0,0,1248,38,0,8,174,3,0,0,1256,46,0,0,174,3,0,0
Jsoup/91,src_main_java_org_jsoup_UncheckedIOException,10,2,14,4,0,0,3,1,0,0,14,4,0,0,3,1,0,0,14,4,0,0,3,1,0,0
Jsoup/91,src_main_java_org_jsoup_parser_CharacterReader,432,50,452,20,0,0,53,3,0,0,448,16,0,4,53,3,0,0,452,20,0,0,53,3,0,0
Jsoup/92,src_main_java_org_jsoup_nodes_Attributes,358,55,374,16,0,0,58,3,0,0,371,13,0,3,58,3,0,0,374,16,0,0,58,3,0,0
Jsoup/92,src_main_java_org_jsoup_parser_HtmlTreeBuilder,682,96,700,18,0,0,98,2,0,0,697,15,0,3,98,2,0,0,700,18,0,0,98,2,0,0
Jsoup/92,src_main_java_org_jsoup_parser_ParseSettings,38,9,44,6,0,0,10,1,0,0,44,6,0,0,10,1,0,0,44,6,0,0,10,1,0,0
Jsoup/92,src_main_java_org_jsoup_parser_Token,375,85,407,32,0,0,88,3,0,0,404,29,0,3,88,3,0,0,407,32,0,0,88,3,0,0
Jsoup/92,src_main_java_org_jsoup_parser_XmlTreeBuilder,124,12,142,18,0,0,14,2,0,0,142,18,0,0,14,2,0,0,142,18,0,0,14,2,0,0
Jsoup/93,src_main_java_org_jsoup_nodes_FormElement,35,6,76,41,0,0,8,2,0,0,76,41,0,0,8,2,0,0,76,41,0,0,8,2,0,0
JxPath/1,src_java_org_apache_commons_jxpath_ri_model_dom_DOMNodePointer,638,49,691,53,0,0,51,2,0,0,688,50,0,3,51,2,0,0,691,53,0,0,51,2,0,0
JxPath/1,src_java_org_apache_commons_jxpath_ri_model_jdom_JDOMNodePointer,642,45,693,51,0,2,47,2,0,0,692,50,0,3,47,2,0,0,695,53,0,0,47,2,0,0
JxPath/10,src_java_org_apache_commons_jxpath_ri_compiler_CoreOperationRelationalExpression,95,8,109,14,0,0,10,2,0,0,109,14,0,0,10,2,0,0,109,14,0,0,10,2,0,0
JxPath/11,src_java_org_apache_commons_jxpath_ri_model_dom_DOMAttributeIterator,93,10,124,31,0,0,12,2,0,0,124,31,0,0,12,2,0,0,124,31,0,0,12,2,0,0
JxPath/11,src_java_org_apache_commons_jxpath_ri_model_jdom_JDOMAttributeIterator,30,6,77,47,0,0,8,2,0,0,75,45,3,2,8,2,0,0,75,45,3,2,8,2,0,0
JxPath/12,src_java_org_apache_commons_jxpath_ri_model_dom_DOMNodePointer,610,50,664,54,0,0,52,2,0,0,661,51,0,3,52,2,0,0,664,54,0,0,52,2,0,0
JxPath/14,src_java_org_apache_commons_jxpath_ri_compiler_CoreFunction,681,42,709,28,0,0,46,4,0,0,706,25,0,3,46,4,0,0,709,28,0,0,46,4,0,0
JxPath/15,src_java_org_apache_commons_jxpath_ri_axes_UnionContext,12,4,39,27,0,0,6,2,0,0,38,26,1,1,6,2,0,0,38,26,1,1,6,2,0,0
JxPath/16,src_java_org_apache_commons_jxpath_ri_model_dom_DOMNodePointer,638,52,690,52,0,1,54,2,0,0,688,50,0,3,54,2,0,0,690,52,0,1,54,2,0,0
JxPath/16,src_java_org_apache_commons_jxpath_ri_model_jdom_JDOMNodePointer,655,48,705,50,0,1,50,2,0,0,703,48,0,3,50,2,0,0,705,50,0,1,50,2,0,0
JxPath/18,src_java_org_apache_commons_jxpath_ri_axes_AttributeContext,33,8,59,26,0,1,10,2,0,0,57,24,5,3,10,2,0,0,58,25,4,2,10,2,0,0
JxPath/19,src_java_org_apache_commons_jxpath_ri_model_dom_DOMNodePointer,632,50,652,20,0,0,52,2,0,0,647,15,4,5,52,2,0,0,651,19,3,1,52,2,0,0
JxPath/19,src_java_org_apache_commons_jxpath_ri_model_jdom_JDOMNodePointer,652,46,682,30,0,0,48,2,0,0,679,27,1,3,48,2,0,0,682,30,2,0,48,2,0,0
JxPath/2,src_java_org_apache_commons_jxpath_ri_compiler_Expression,82,23,109,27,0,0,26,3,0,0,109,27,0,0,26,3,0,0,109,27,0,0,26,3,0,0
JxPath/20,src_java_org_apache_commons_jxpath_ri_compiler_CoreOperationRelationalExpression,70,8,107,37,0,0,10,2,0,0,107,37,0,0,10,2,0,0,107,37,0,0,10,2,0,0
JxPath/21,src_java_org_apache_commons_jxpath_ri_model_beans_PropertyPointer,171,27,183,12,0,0,29,2,0,0,183,12,0,0,29,2,0,0,183,12,0,0,29,2,0,0
JxPath/22,src_java_org_apache_commons_jxpath_ri_model_dom_DOMNodePointer,627,51,658,31,0,1,53,2,0,0,654,27,1,5,53,2,0,0,657,30,0,2,53,2,0,0
JxPath/3,src_java_org_apache_commons_jxpath_ri_model_beans_NullPropertyPointer,153,24,190,37,0,0,27,3,0,0,190,37,0,0,27,3,0,0,190,37,0,0,27,3,0,0
JxPath/5,src_java_org_apache_commons_jxpath_ri_model_NodePointer,444,64,478,34,0,0,66,2,0,0,474,30,0,4,66,2,0,0,478,34,0,0,66,2,0,0
JxPath/6,src_java_org_apache_commons_jxpath_ri_compiler_CoreOperationCompare,65,4,103,38,0,2,6,2,0,0,105,40,0,0,6,2,0,0,105,40,0,0,6,2,0,0
JxPath/7,src_java_org_apache_commons_jxpath_ri_compiler_CoreOperationGreaterThan,11,2,15,4,0,0,3,1,0,0,15,4,8,0,3,1,1,0,15,4,0,0,3,1,0,0
JxPath/7,src_java_org_apache_commons_jxpath_ri_compiler_CoreOperationGreaterThanOrEqual,11,2,15,4,0,0,3,1,0,0,15,4,8,0,3,1,1,0,15,4,0,0,3,1,0,0
JxPath/7,src_java_org_apache_commons_jxpath_ri_compiler_CoreOperationLessThan,11,2,15,4,0,0,3,1,0,0,15,4,8,0,3,1,1,0,15,4,0,0,3,1,0,0
JxPath/7,src_java_org_apache_commons_jxpath_ri_compiler_CoreOperationLessThanOrEqual,11,2,15,4,0,0,3,1,0,0,15,4,8,0,3,1,1,0,15,4,0,0,3,1,0,0
JxPath/7,src_java_org_apache_commons_jxpath_ri_compiler_CoreOperationRelationalExpression,17,3,22,5,0,0,4,1,0,0,22,5,0,0,4,1,0,0,18,1,0,4,3,0,0,1
JxPath/8,src_java_org_apache_commons_jxpath_ri_compiler_CoreOperationRelationalExpression,70,8,101,31,0,0,10,2,0,0,101,31,0,0,10,2,0,0,101,31,0,0,10,2,0,0
Lang/1,src_main_java_org_apache_commons_lang3_math_NumberUtils,684,65,829,145,0,0,67,2,0,0,826,142,0,3,67,2,0,0,829,145,0,0,67,2,0,0
Lang/10,src_main_java_org_apache_commons_lang3_time_FastDateParser,572,95,614,42,0,0,97,2,0,0,611,39,0,3,97,2,0,0,614,42,0,0,97,2,0,0
Lang/11,src_main_java_org_apache_commons_lang3_RandomStringUtils,93,12,167,74,0,0,14,2,0,0,167,74,0,0,14,2,0,0,167,74,0,0,14,2,0,0
Lang/12,src_main_java_org_apache_commons_lang3_RandomStringUtils,93,12,160,67,0,0,14,2,0,0,159,66,1,1,14,2,0,0,159,66,1,1,14,2,0,0
Lang/13,src_main_java_org_apache_commons_lang3_SerializationUtils,103,7,132,29,0,0,11,4,0,0,131,28,1,1,11,4,0,0,131,28,1,1,11,4,0,0
Lang/14,src_main_java_org_apache_commons_lang3_StringUtils,2894,177,2911,17,0,0,179,2,0,0,2908,14,0,3,179,2,0,0,2911,17,0,0,179,2,0,0
Lang/15,src_main_java_org_apache_commons_lang3_reflect_TypeUtils,530,26,591,61,0,4,29,3,0,0,589,59,6,6,29,3,0,0,591,61,2,4,29,3,0,0
Lang/16,src_main_java_org_apache_commons_lang3_math_NumberUtils,709,64,836,127,0,0,66,2,0,0,833,124,0,3,66,2,0,0,836,127,0,0,66,2,0,0
Lang/17,src_main_java_org_apache_commons_lang3_text_translate_CharSequenceTranslator,41,4,72,31,0,0,6,2,0,0,71,30,1,1,6,2,0,0,69,28,3,3,6,2,0,0
Lang/18,src_main_java_org_apache_commons_lang3_time_FastDateFormat,845,143,969,124,0,0,145,2,0,0,962,117,1,7,145,2,0,0,965,120,1,4,145,2,0,0
Lang/19,src_main_java_org_apache_commons_lang3_text_translate_NumericEntityUnescaper,0,0,52,52,0,0,2,2,0,0,49,49,3,3,2,2,0,0,48,48,3,4,2,2,0,0
Lang/20,src_main_java_org_apache_commons_lang3_StringUtils,2821,174,2902,81,0,6,177,3,0,0,2903,82,4,5,177,3,0,0,2902,81,4,6,177,3,0,0
Lang/21,src_main_java_org_apache_commons_lang3_time_DateUtils,826,79,842,16,0,0,81,2,0,0,839,13,0,3,81,2,0,0,842,16,0,0,81,2,0,0
Lang/22,src_main_java_org_apache_commons_lang3_math_Fraction,472,51,517,45,0,0,53,2,0,0,513,41,0,4,53,2,0,0,517,45,0,0,53,2,0,0
Lang/23,src_main_java_org_apache_commons_lang3_text_ExtendedMessageFormat,312,28,316,4,0,0,29,1,0,0,313,1,0,3,29,1,0,0,316,4,0,0,29,1,0,0
Lang/24,src_main_java_org_apache_commons_lang3_math_NumberUtils,749,64,838,89,0,0,66,2,0,0,835,86,0,3,66,2,0,0,838,89,0,0,66,2,0,0
Lang/26,src_main_java_org_apache_commons_lang3_time_FastDateFormat,1117,160,1129,12,0,0,162,2,0,0,1126,9,0,3,162,2,0,0,1129,12,0,0,162,2,0,0
Lang/27,src_main_java_org_apache_commons_lang3_math_NumberUtils,711,64,836,125,0,0,66,2,0,0,833,122,0,3,66,2,0,0,836,125,0,0,66,2,0,0
Lang/28,src_main_java_org_apache_commons_lang3_text_translate_NumericEntityUnescaper,0,0,39,39,0,0,2,2,0,0,39,39,0,0,2,2,0,0,39,39,0,0,2,2,0,0
Lang/29,src_main_java_org_apache_commons_lang3_SystemUtils,216,100,225,9,0,0,102,2,0,0,222,6,0,3,102,2,0,0,225,9,0,0,102,2,0,0
Lang/3,src_main_java_org_apache_commons_lang3_math_NumberUtils,684,65,823,139,0,0,67,2,0,0,818,134,2,5,67,2,0,0,821,137,2,2,67,2,0,0
Lang/30,src_main_java_org_apache_commons_lang3_StringUtils,2587,155,2718,131,3,1,162,7,0,0,2703,116,16,16,162,7,0,0,2705,118,13,14,162,7,0,0
Lang/31,src_main_java_org_apache_commons_lang3_StringUtils,2674,160,2698,24,0,0,162,2,0,0,2694,20,1,4,162,2,0,0,2697,23,1,1,162,2,0,0
Lang/32,src_main_java_org_apache_commons_lang3_builder_HashCodeBuilder,374,35,399,25,0,0,40,5,0,0,395,21,3,4,40,5,0,0,398,24,3,1,40,5,0,0
Lang/33,src_main_java_org_apache_commons_lang3_ClassUtils,540,43,587,47,0,0,45,2,0,0,584,44,0,3,45,2,0,0,587,47,0,0,45,2,0,0
Lang/34,src_main_java_org_apache_commons_lang3_builder_ToStringStyle,1232,156,1251,19,0,0,159,3,0,0,1247,15,0,4,159,3,0,0,1251,19,0,0,159,3,0,0
Lang/35,src_main_java_org_apache_commons_lang3_ArrayUtils,2435,193,2476,41,0,0,196,3,0,0,2473,38,2,3,196,3,0,0,2474,39,0,2,196,3,0,0
Lang/36,src_java_org_apache_commons_lang3_math_NumberUtils,625,63,830,205,0,0,66,3,0,0,827,202,0,3,66,3,0,0,830,205,0,0,66,3,0,0
Lang/37,src_java_org_apache_commons_lang3_ArrayUtils,2433,193,2456,23,0,0,195,2,0,0,2453,20,0,3,195,2,0,0,2456,23,0,0,195,2,0,0
Lang/38,src_java_org_apache_commons_lang3_time_FastDateFormat,1113,160,1128,15,0,0,162,2,0,0,1125,12,0,3,162,2,0,0,1128,15,0,0,162,2,0,0
Lang/39,src_java_org_apache_commons_lang3_StringUtils,2484,153,2572,88,0,0,155,2,0,0,2569,85,0,3,155,2,0,0,2572,88,0,0,155,2,0,0
Lang/4,src_main_java_org_apache_commons_lang3_text_translate_LookupTranslator,0,2,51,51,0,0,6,4,0,0,51,51,0,0,6,4,0,0,50,50,0,1,6,4,0,0
Lang/40,src_java_org_apache_commons_lang_StringUtils,2515,152,2528,13,0,0,154,2,0,0,2525,10,5,3,154,2,0,0,2528,13,5,0,154,2,0,0
Lang/41,src_java_org_apache_commons_lang_ClassUtils,505,42,569,64,0,0,45,3,0,0,558,53,0,11,44,2,0,1,564,59,0,5,45,3,0,0
Lang/43,src_java_org_apache_commons_lang_text_ExtendedMessageFormat,276,27,309,33,0,0,29,2,0,0,306,30,0,3,29,2,0,0,309,33,0,0,29,2,0,0
Lang/44,src_java_org_apache_commons_lang_NumberUtils,283,18,408,125,0,0,20,2,0,0,404,121,0,4,20,2,0,0,408,125,0,0,20,2,0,0
Lang/45,src_java_org_apache_commons_lang_WordUtils,240,13,280,40,0,0,15,2,0,0,277,37,0,3,15,2,0,0,280,40,0,0,15,2,0,0
Lang/46,src_java_org_apache_commons_lang_StringEscapeUtils,329,23,464,135,0,0,30,7,0,0,461,132,0,3,30,7,0,0,464,135,0,0,30,7,0,0
Lang/47,src_java_org_apache_commons_lang_text_StrBuilder,1639,161,1689,50,0,0,164,3,0,0,1686,47,0,3,164,3,0,0,1689,50,0,0,164,3,0,0
Lang/48,src_java_org_apache_commons_lang_builder_EqualsBuilder,439,29,492,53,0,0,31,2,0,0,488,49,1,4,31,2,0,0,491,52,1,1,31,2,0,0
Lang/49,src_java_org_apache_commons_lang_math_Fraction,492,51,507,15,0,0,53,2,0,0,503,11,0,4,53,2,0,0,507,15,0,0,53,2,0,0
Lang/50,src_java_org_apache_commons_lang_time_FastDateFormat,1055,160,1118,63,0,0,163,3,0,0,1115,60,0,3,163,3,0,0,1118,63,0,0,163,3,0,0
Lang/51,src_java_org_apache_commons_lang_BooleanUtils,439,36,479,40,0,0,38,2,0,0,476,37,0,3,38,2,0,0,479,40,0,0,38,2,0,0
Lang/52,src_java_org_apache_commons_lang_StringEscapeUtils,298,20,379,81,0,0,22,2,0,0,373,75,3,6,22,2,0,0,377,79,2,2,22,2,0,0
Lang/53,src_java_org_apache_commons_lang_time_DateUtils,389,49,484,95,0,0,51,2,0,0,481,92,0,3,51,2,0,0,484,95,0,0,51,2,0,0
Lang/54,src_java_org_apache_commons_lang_LocaleUtils,105,12,149,44,0,0,14,2,0,0,149,44,0,0,14,2,0,0,149,44,0,0,14,2,0,0
Lang/55,src_java_org_apache_commons_lang_time_StopWatch,94,21,106,12,0,0,23,2,0,0,106,12,0,0,23,2,0,0,106,12,0,0,23,2,0,0
Lang/56,src_java_org_apache_commons_lang_time_FastDateFormat,1109,159,1113,4,0,0,162,3,0,0,1110,1,0,3,162,3,0,0,1113,4,0,0,162,3,0,0
Lang/57,src_java_org_apache_commons_lang_LocaleUtils,136,12,149,13,0,0,14,2,0,0,149,13,1,0,14,2,0,0,149,13,0,0,14,2,0,0
Lang/58,src_java_org_apache_commons_lang_math_NumberUtils,842,70,970,128,0,0,72,2,0,0,964,122,5,6,72,2,0,0,967,125,6,3,72,2,0,0
Lang/59,src_java_org_apache_commons_lang_text_StrBuilder,1492,140,1517,25,3,3,142,2,0,0,1517,25,0,3,142,2,0,0,1517,25,1,3,142,2,0,0
Lang/6,src_main_java_org_apache_commons_lang3_text_translate_CharSequenceTranslator,41,4,74,33,0,0,6,2,0,0,74,33,0,0,6,2,0,0,74,33,0,0,6,2,0,0
Lang/60,src_java_org_apache_commons_lang_text_StrBuilder,1486,139,1519,33,0,0,142,3,0,0,1516,30,0,3,142,3,0,0,1519,33,0,0,142,3,0,0
Lang/61,src_java_org_apache_commons_lang_text_StrBuilder,1483,140,1520,37,0,0,142,2,0,0,1517,34,0,3,142,2,0,0,1518,35,0,2,142,2,0,0
Lang/63,src_java_org_apache_commons_lang_time_DurationFormatUtils,326,30,408,82,0,1,32,2,0,0,406,80,4,3,32,2,0,0,408,82,5,1,32,2,0,0
Lang/64,src_java_org_apache_commons_lang_enums_ValuedEnum,40,6,51,11,0,0,8,2,0,0,51,11,0,0,8,2,0,0,51,11,0,0,8,2,0,0
Lang/65,src_java_org_apache_commons_lang_time_DateUtils,389,49,454,65,0,0,51,2,0,0,451,62,0,3,51,2,0,0,454,65,0,0,51,2,0,0
Lang/7,src_main_java_org_apache_commons_lang3_math_NumberUtils,696,63,840,144,0,3,66,3,0,0,838,142,1,5,66,3,0,0,843,147,0,0,66,3,0,0
Lang/8,src_main_java_org_apache_commons_lang3_time_FastDatePrinter,823,122,856,33,0,0,126,4,0,0,852,29,0,4,126,4,0,0,855,32,0,1,126,4,0,0
Lang/9,src_main_java_org_apache_commons_lang3_time_FastDateParser,575,95,614,39,0,0,97,2,0,0,611,36,0,3,97,2,0,0,614,39,0,0,97,2,0,0
Math/1,src_main_java_org_apache_commons_math3_fraction_BigFraction,456,71,518,62,0,0,73,2,0,0,515,59,0,3,73,2,0,0,518,62,0,0,73,2,0,0
Math/1,src_main_java_org_apache_commons_math3_fraction_Fraction,284,48,346,62,0,0,50,2,0,0,343,59,0,3,50,2,0,0,346,62,0,0,50,2,0,0
Math/10,src_main_java_org_apache_commons_math3_analysis_differentiation_DSCompiler,1016,54,1051,35,0,0,56,2,0,0,1048,32,0,3,56,2,0,0,1051,35,0,0,56,2,0,0
Math/100,src_java_org_apache_commons_math_estimation_AbstractEstimator,101,21,153,52,0,0,24,3,0,0,149,48,0,4,24,3,0,0,153,52,0,0,24,3,0,0
Math/101,src_java_org_apache_commons_math_complex_ComplexFormat,265,32,316,51,0,0,34,2,0,0,313,48,0,3,34,2,0,0,316,51,0,0,34,2,0,0
Math/102,src_java_org_apache_commons_math_stat_inference_ChiSquareTestImpl,229,18,253,24,0,0,20,2,0,0,249,20,1,4,20,2,0,0,252,23,1,1,20,2,0,0
Math/103,src_java_org_apache_commons_math_distribution_NormalDistributionImpl,89,13,102,13,0,0,15,2,0,0,101,12,1,1,15,2,0,0,101,12,1,1,15,2,0,0
Math/104,src_java_org_apache_commons_math_special_Gamma,116,12,121,5,0,0,14,2,0,0,121,5,0,0,14,2,0,0,121,5,0,0,14,2,0,0
Math/105,src_java_org_apache_commons_math_stat_regression_SimpleRegression,157,30,167,10,0,0,32,2,0,0,164,7,0,3,32,2,0,0,167,10,0,0,32,2,0,0
Math/106,src_java_org_apache_commons_math_fraction_ProperFractionFormat,53,8,101,48,0,0,10,2,0,0,101,48,0,0,10,2,0,0,101,48,0,0,10,2,0,0
Math/11,src_main_java_org_apache_commons_math3_distribution_MultivariateNormalDistribution,102,12,119,17,0,0,14,2,0,0,118,16,1,1,14,2,0,0,117,15,0,2,14,2,0,0
Math/12,src_main_java_org_apache_commons_math3_random_BitsStreamGenerator,114,15,119,5,0,0,16,1,0,0,119,5,0,0,16,1,0,0,119,5,0,0,16,1,0,0
Math/13,src_main_java_org_apache_commons_math3_optimization_general_AbstractLeastSquaresOptimizer,194,32,206,12,0,0,34,2,0,0,199,5,1,7,33,1,0,1,205,11,1,1,34,2,0,0
Math/14,src_main_java_org_apache_commons_math3_optim_nonlinear_vector_Weight,13,3,22,9,0,1,5,2,0,0,23,10,2,0,5,2,0,0,23,10,0,0,5,2,0,0
Math/14,src_main_java_org_apache_commons_math3_optim_nonlinear_vector_jacobian_AbstractLeastSquaresOptimizer,96,14,108,12,0,0,16,2,0,0,107,11,1,1,16,2,0,0,107,11,1,1,16,2,0,0
Math/15,src_main_java_org_apache_commons_math3_util_FastMath,2202,130,2333,131,0,0,132,2,0,0,2330,128,0,3,132,2,0,0,2333,131,0,0,132,2,0,0
Math/16,src_main_java_org_apache_commons_math3_util_FastMath,2189,128,2311,122,0,0,131,3,0,0,2300,111,8,11,131,3,0,0,2303,114,10,8,131,3,0,0
Math/17,src_main_java_org_apache_commons_math3_dfp_Dfp,1665,95,1674,9,0,0,97,2,0,0,1670,5,1,4,97,2,0,0,1673,8,1,1,97,2,0,0
Math/18,src_main_java_org_apache_commons_math3_optimization_direct_CMAESOptimizer,839,108,889,50,0,5,113,5,0,0,888,49,2,6,113,5,0,0,892,53,2,2,113,5,0,0
Math/19,src_main_java_org_apache_commons_math3_optimization_direct_CMAESOptimizer,831,111,881,50,0,0,113,2,0,0,878,47,0,3,113,2,0,0,881,50,0,0,113,2,0,0
Math/2,src_main_java_org_apache_commons_math3_distribution_HypergeometricDistribution,172,23,184,12,0,0,25,2,0,0,179,7,4,5,25,2,0,0,184,12,0,0,25,2,0,0
Math/20,src_main_java_org_apache_commons_math3_optimization_direct_CMAESOptimizer,869,110,882,13,0,0,113,3,0,0,879,10,0,3,113,3,0,0,882,13,0,0,113,3,0,0
Math/21,src_main_java_org_apache_commons_math3_linear_RectangularCholeskyDecomposition,10,4,82,72,0,2,6,2,0,0,83,73,9,1,6,2,0,0,79,69,1,5,6,2,0,0
Math/22,src_main_java_org_apache_commons_math3_distribution_FDistribution,124,22,134,10,0,0,24,2,0,0,134,10,0,0,24,2,0,0,134,10,0,0,24,2,0,0
Math/22,src_main_java_org_apache_commons_math3_distribution_UniformRealDistribution,99,19,109,10,0,0,21,2,0,0,109,10,0,0,21,2,0,0,109,10,0,0,21,2,0,0
Math/23,src_main_java_org_apache_commons_math3_optimization_univariate_BrentOptimizer,39,7,180,141,0,0,9,2,0,0,177,138,0,3,9,2,0,0,180,141,0,0,9,2,0,0
Math/24,src_main_java_org_apache_commons_math3_optimization_univariate_BrentOptimizer,39,7,176,137,0,4,9,2,0,0,177,138,0,3,9,2,0,0,176,137,0,4,9,2,0,0
Math/25,src_main_java_org_apache_commons_math3_optimization_fitting_HarmonicFitter,74,11,139,65,0,0,14,3,0,0,136,62,0,3,14,3,0,0,139,65,0,0,14,3,0,0
Math/26,src_main_java_org_apache_commons_math3_fraction_Fraction,284,47,349,65,0,0,49,2,0,0,346,62,0,3,49,2,0,0,346,62,0,3,49,2,0,0
Math/27,src_main_java_org_apache_commons_math3_fraction_Fraction,337,47,345,8,0,3,49,2,0,0,338,1,0,10,48,1,0,1,346,9,0,2,49,2,0,0
Math/28,src_main_java_org_apache_commons_math3_optimization_linear_SimplexSolver,79,10,136,57,0,0,12,2,0,0,136,57,0,0,12,2,0,0,136,57,0,0,12,2,0,0
Math/29,src_main_java_org_apache_commons_math3_linear_OpenMapRealVector,625,66,656,31,0,0,69,3,0,0,647,22,2,9,68,2,0,1,653,28,2,3,69,3,0,0
Math/3,src_main_java_org_apache_commons_math3_util_MathArrays,816,47,867,51,0,0,49,2,0,0,864,48,0,3,49,2,0,0,867,51,0,0,49,2,0,0
Math/30,src_main_java_org_apache_commons_math3_stat_inference_MannWhitneyUTest,66,7,85,19,0,0,9,2,0,0,85,19,0,0,9,2,0,0,85,19,0,0,9,2,0,0
Math/31,src_main_java_org_apache_commons_math3_util_ContinuedFraction,36,7,76,40,13,12,9,2,0,0,88,52,23,0,9,2,0,0,82,46,3,6,9,2,0,0
Math/32,src_main_java_org_apache_commons_math3_geometry_euclidean_twod_PolygonsSet,244,24,293,49,0,0,26,2,0,0,290,46,0,3,26,2,0,0,293,49,0,0,26,2,0,0
Math/33,src_main_java_org_apache_commons_math3_optimization_linear_SimplexTableau,328,44,367,39,0,0,46,2,0,0,365,37,0,2,46,2,0,0,367,39,0,0,46,2,0,0
Math/34,src_main_java_org_apache_commons_math3_genetics_ListPopulation,102,14,112,10,0,0,16,2,0,0,112,10,1,0,16,2,0,0,112,10,0,0,16,2,0,0
Math/35,src_main_java_org_apache_commons_math3_genetics_ElitisticListPopulation,26,4,47,21,0,0,7,3,0,0,47,21,2,0,7,3,0,0,45,19,0,2,7,3,0,0
Math/36,src_main_java_org_apache_commons_math_fraction_BigFraction,489,70,507,18,0,0,73,3,0,0,504,15,0,3,73,3,0,0,507,18,0,0,73,3,0,0
Math/37,src_main_java_org_apache_commons_math_complex_Complex,428,52,455,27,0,0,55,3,0,0,452,24,0,3,55,3,0,0,451,23,0,4,55,3,0,0
Math/38,src_main_java_org_apache_commons_math_optimization_direct_BOBYQAOptimizer,1495,54,1642,147,0,0,56,2,0,0,1636,141,0,6,56,2,0,0,1638,143,0,4,56,2,0,0
Math/39,src_main_java_org_apache_commons_math_ode_nonstiff_EmbeddedRungeKuttaIntegrator,91,19,192,101,0,0,21,2,0,0,188,97,0,4,21,2,0,0,192,101,0,0,21,2,0,0
Math/4,src_main_java_org_apache_commons_math3_geometry_euclidean_threed_SubLine,42,7,59,17,0,0,9,2,0,0,59,17,0,0,9,2,0,0,59,17,0,0,9,2,0,0
Math/4,src_main_java_org_apache_commons_math3_geometry_euclidean_twod_SubLine,84,8,103,19,0,0,10,2,0,0,103,19,0,0,10,2,0,0,103,19,0,0,10,2,0,0
Math/40,src_main_java_org_apache_commons_math_analysis_solvers_BracketingNthOrderBrentSolver,91,14,222,131,0,6,16,2,0,0,223,132,2,5,16,2,0,0,218,127,2,10,16,2,0,0
Math/41,src_main_java_org_apache_commons_math_stat_descriptive_moment_Variance,206,24,247,41,0,0,26,2,0,0,244,38,0,3,26,2,0,0,247,41,0,0,26,2,0,0
Math/42,src_main_java_org_apache_commons_math_optimization_linear_SimplexTableau,336,44,363,27,0,0,46,2,0,0,361,25,0,2,46,2,0,0,363,27,0,0,46,2,0,0
Math/43,src_main_java_org_apache_commons_math_stat_descriptive_SummaryStatistics,331,57,360,29,0,0,59,2,0,0,357,26,3,3,59,2,0,0,357,26,0,3,59,2,0,0
Math/44,src_main_java_org_apache_commons_math_ode_AbstractIntegrator,174,33,245,71,0,0,35,2,0,0,241,67,0,4,35,2,0,0,245,71,0,0,35,2,0,0
Math/45,src_main_java_org_apache_commons_math_linear_OpenMapRealMatrix,190,19,205,15,0,0,21,2,0,0,202,12,0,3,21,2,0,0,205,15,0,0,21,2,0,0
Math/46,src_main_java_org_apache_commons_math_complex_Complex,375,51,422,47,0,0,54,3,0,0,419,44,0,3,54,3,0,0,417,42,0,5,54,3,0,0
Math/47,src_main_java_org_apache_commons_math_complex_Complex,365,49,421,56,0,0,53,4,0,0,418,53,0,3,53,4,0,0,416,51,0,5,53,4,0,0
Math/48,src_main_java_org_apache_commons_math_analysis_solvers_BaseSecantSolver,60,10,153,93,0,0,12,2,0,0,153,93,0,0,12,2,0,0,153,93,0,0,12,2,0,0
Math/49,src_main_java_org_apache_commons_math_linear_OpenMapRealVector,713,75,773,60,0,0,80,5,0,0,770,57,0,3,80,5,0,0,769,56,4,4,80,5,0,0
Math/5,src_main_java_org_apache_commons_math3_complex_Complex,441,53,467,26,0,0,55,2,0,0,464,23,0,3,55,2,0,0,467,26,0,0,55,2,0,0
Math/50,src_main_java_org_apache_commons_math_analysis_solvers_BaseSecantSolver,60,10,153,93,0,0,12,2,0,0,153,93,0,0,12,2,0,0,153,93,0,0,12,2,0,0
Math/51,src_main_java_org_apache_commons_math_analysis_solvers_BaseSecantSolver,60,10,150,90,0,0,12,2,0,0,149,89,1,1,12,2,0,0,150,90,0,0,12,2,0,0
Math/52,src_main_java_org_apache_commons_math_geometry_euclidean_threed_Rotation,410,26,475,65,0,0,28,2,0,0,472,62,0,3,28,2,0,0,475,65,0,0,28,2,0,0
Math/53,src_main_java_org_apache_commons_math_complex_Complex,342,44,353,11,0,0,46,2,0,0,350,8,0,3,46,2,0,0,353,11,0,0,46,2,0,0
Math/54,src_main_java_org_apache_commons_math_dfp_Dfp,1488,86,1600,112,1,2,89,3,0,0,1599,111,0,3,89,3,0,0,1602,114,0,0,89,3,0,0
Math/55,src_main_java_org_apache_commons_math_geometry_Vector3D,286,49,316,30,0,0,51,2,0,0,290,4,1,26,50,1,0,1,293,7,1,23,50,1,0,1
Math/56,src_main_java_org_apache_commons_math_util_MultidimensionalCounter,120,22,145,25,0,1,24,2,0,0,146,26,1,0,24,2,0,0,146,26,0,0,24,2,0,0
Math/57,src_main_java_org_apache_commons_math_stat_clustering_KMeansPlusPlusClusterer,155,11,192,37,0,0,13,2,0,0,189,34,0,3,13,2,0,0,192,37,0,0,13,2,0,0
Math/58,src_main_java_org_apache_commons_math_optimization_fitting_GaussianFitter,185,17,195,10,0,0,19,2,0,0,192,7,0,3,19,2,0,0,195,10,0,0,19,2,0,0
Math/59,src_main_java_org_apache_commons_math_util_FastMath,2205,90,2245,40,0,0,92,2,0,0,2242,37,0,3,92,2,0,0,2245,40,0,0,92,2,0,0
Math/6,src_main_java_org_apache_commons_math3_optim_BaseOptimizer,89,17,100,11,0,0,19,2,0,0,100,11,0,0,19,2,0,0,100,11,0,0,19,2,0,0
Math/6,src_main_java_org_apache_commons_math3_optim_nonlinear_scalar_gradient_NonLinearConjugateGradientOptimizer,124,23,202,78,0,0,25,2,0,0,199,75,4,3,25,2,0,0,202,78,0,0,25,2,0,0
Math/6,src_main_java_org_apache_commons_math3_optim_nonlinear_scalar_noderiv_CMAESOptimizer,727,107,850,123,0,0,109,2,0,0,847,120,0,3,109,2,0,0,850,123,0,0,109,2,0,0
Math/6,src_main_java_org_apache_commons_math3_optim_nonlinear_scalar_noderiv_PowellOptimizer,95,17,176,81,0,0,19,2,0,0,173,78,3,3,19,2,0,0,176,81,0,0,19,2,0,0
Math/6,src_main_java_org_apache_commons_math3_optim_nonlinear_scalar_noderiv_SimplexOptimizer,56,8,88,32,0,0,10,2,0,0,88,32,3,0,10,2,0,0,88,32,0,0,10,2,0,0
Math/6,src_main_java_org_apache_commons_math3_optim_nonlinear_vector_jacobian_GaussNewtonOptimizer,19,4,86,67,0,0,6,2,0,0,86,67,3,0,6,2,0,0,86,67,0,0,6,2,0,0
Math/6,src_main_java_org_apache_commons_math3_optim_nonlinear_vector_jacobian_LevenbergMarquardtOptimizer,332,25,523,191,0,0,27,2,0,0,518,186,1,5,27,2,0,0,523,191,0,0,27,2,0,0
Math/60,src_main_java_org_apache_commons_math_distribution_NormalDistributionImpl,110,18,124,14,0,0,20,2,0,0,123,13,1,1,20,2,0,0,123,13,1,1,20,2,0,0
Math/61,src_main_java_org_apache_commons_math_distribution_PoissonDistributionImpl,79,17,97,18,0,3,19,2,0,0,100,21,2,0,19,2,0,0,99,20,0,1,19,2,0,0
Math/62,src_main_java_org_apache_commons_math_optimization_univariate_MultiStartUnivariateRealOptimizer,66,15,108,42,1,6,18,3,0,0,111,45,4,3,18,3,0,0,111,45,0,3,18,3,0,0
Math/63,src_main_java_org_apache_commons_math_util_MathUtils,1143,81,1154,11,0,1,83,2,0,0,1151,8,2,4,83,2,0,0,1155,12,0,0,83,2,0,0
Math/64,src_main_java_org_apache_commons_math_optimization_general_LevenbergMarquardtOptimizer,313,23,487,174,0,0,25,2,0,0,480,167,2,7,25,2,0,0,485,172,2,2,25,2,0,0
Math/65,src_main_java_org_apache_commons_math_optimization_general_AbstractLeastSquaresOptimizer,175,35,197,22,0,0,38,3,0,0,178,3,10,19,36,1,1,2,182,7,10,15,36,1,1,2
Math/66,src_main_java_org_apache_commons_math_optimization_univariate_BrentOptimizer,0,1,149,149,3,4,5,4,0,0,147,147,15,6,4,3,1,1,140,140,9,13,4,3,1,1
Math/67,src_main_java_org_apache_commons_math_optimization_MultiStartUnivariateRealOptimizer,184,28,198,14,0,0,31,3,0,0,185,1,0,13,29,1,0,2,198,14,0,0,31,3,0,0
Math/68,src_main_java_org_apache_commons_math_optimization_general_LevenbergMarquardtOptimizer,297,20,468,171,1,1,23,3,0,0,464,167,0,5,23,3,0,0,469,172,0,0,23,3,0,0
Math/69,src_main_java_org_apache_commons_math_stat_correlation_PearsonsCorrelation,118,14,140,22,0,5,16,2,0,0,142,24,1,3,16,2,0,0,141,23,1,4,16,2,0,0
Math/7,src_main_java_org_apache_commons_math3_ode_AbstractIntegrator,190,33,261,71,0,15,35,2,0,0,271,81,4,5,35,2,0,0,275,85,0,1,35,2,0,0
Math/70,src_main_java_org_apache_commons_math_analysis_solvers_BisectionSolver,63,5,78,15,0,0,7,2,0,0,78,15,0,0,7,2,0,0,78,15,0,0,7,2,0,0
Math/71,src_main_java_org_apache_commons_math_ode_nonstiff_EmbeddedRungeKuttaIntegrator,91,19,219,128,0,0,21,2,0,0,215,124,0,4,21,2,0,0,217,126,0,2,21,2,0,0
Math/71,src_main_java_org_apache_commons_math_ode_nonstiff_RungeKuttaIntegrator,15,6,111,96,0,0,8,2,0,0,111,96,0,0,8,2,0,0,109,94,0,2,8,2,0,0
Math/72,src_main_java_org_apache_commons_math_analysis_solvers_BrentSolver,153,8,196,43,0,0,10,2,0,0,193,40,0,3,10,2,0,0,196,43,0,0,10,2,0,0
Math/73,src_main_java_org_apache_commons_math_analysis_solvers_BrentSolver,153,8,191,38,0,0,10,2,0,0,188,35,0,3,10,2,0,0,191,38,0,0,10,2,0,0
Math/74,src_main_java_org_apache_commons_math_ode_nonstiff_EmbeddedRungeKuttaIntegrator,91,19,215,124,0,0,21,2,0,0,208,117,11,7,21,2,0,0,212,121,0,3,21,2,0,0
Math/75,src_main_java_org_apache_commons_math_stat_Frequency,317,38,329,12,0,0,40,2,0,0,326,9,0,3,40,2,0,0,329,12,0,0,40,2,0,0
Math/76,src_main_java_org_apache_commons_math_linear_SingularValueDecompositionImpl,182,35,258,76,0,4,38,3,0,0,255,73,10,7,38,3,0,0,258,76,2,4,38,3,0,0
Math/77,src_main_java_org_apache_commons_math_linear_ArrayRealVector,979,106,995,16,0,0,108,2,0,0,992,13,0,3,108,2,0,0,995,16,0,0,108,2,0,0
Math/77,src_main_java_org_apache_commons_math_linear_OpenMapRealVector,771,79,777,6,0,0,80,1,0,0,774,3,0,3,80,1,0,0,777,6,0,0,80,1,0,0
Math/78,src_main_java_org_apache_commons_math_ode_events_EventState,106,24,166,60,0,0,26,2,0,0,163,57,0,3,26,2,0,0,166,60,0,0,26,2,0,0
Math/79,src_main_java_org_apache_commons_math_util_MathUtils,957,72,976,19,0,0,74,2,0,0,972,15,0,4,74,2,0,0,976,19,0,0,74,2,0,0
Math/8,src_main_java_org_apache_commons_math3_distribution_DiscreteDistribution,67,9,84,17,0,3,11,2,0,0,86,19,2,1,11,2,0,0,86,19,0,1,11,2,0,0
Math/80,src_main_java_org_apache_commons_math_linear_EigenDecompositionImpl,1225,76,1251,26,0,0,78,2,0,0,1246,21,4,5,78,2,0,0,1248,23,2,3,78,2,0,0
Math/81,src_main_java_org_apache_commons_math_linear_EigenDecompositionImpl,920,74,1250,330,0,0,78,4,0,0,1240,320,0,10,78,4,0,0,1250,330,0,0,78,4,0,0
Math/82,src_main_java_org_apache_commons_math_optimization_linear_SimplexSolver,99,10,124,25,0,0,12,2,0,0,124,25,0,0,12,2,0,0,124,25,0,0,12,2,0,0
Math/83,src_main_java_org_apache_commons_math_optimization_linear_SimplexTableau,299,41,340,41,0,0,44,3,0,0,338,39,0,2,44,3,0,0,340,41,0,0,44,3,0,0
Math/84,src_main_java_org_apache_commons_math_optimization_direct_MultiDirectional,35,5,66,31,0,0,7,2,0,0,66,31,0,0,7,2,0,0,66,31,0,0,7,2,0,0
Math/85,src_java_org_apache_commons_math_analysis_solvers_UnivariateRealSolverUtils,64,8,105,41,0,0,10,2,0,0,105,41,0,0,10,2,0,0,105,41,0,0,10,2,0,0
Math/86,src_java_org_apache_commons_math_linear_CholeskyDecompositionImpl,171,19,219,48,0,0,21,2,0,0,215,44,0,4,21,2,0,0,219,48,0,0,21,2,0,0
Math/87,src_java_org_apache_commons_math_optimization_linear_SimplexTableau,299,39,318,19,0,0,41,2,0,0,313,14,3,5,41,2,0,0,315,16,3,3,41,2,0,0
Math/88,src_java_org_apache_commons_math_optimization_linear_SimplexTableau,297,39,314,17,0,0,41,2,0,0,312,15,0,2,41,2,0,0,314,17,1,0,41,2,0,0
Math/89,src_java_org_apache_commons_math_stat_Frequency,255,32,266,11,0,0,34,2,0,0,262,7,1,4,34,2,0,0,265,10,1,1,34,2,0,0
Math/9,src_main_java_org_apache_commons_math3_geometry_euclidean_threed_Line,120,18,128,8,0,1,20,2,0,0,128,8,6,1,20,2,0,0,129,9,0,0,20,2,0,0
Math/90,src_java_org_apache_commons_math_stat_Frequency,236,31,260,24,0,0,33,2,0,0,253,17,4,7,32,1,1,1,256,20,4,4,32,1,1,1
Math/91,src_java_org_apache_commons_math_fraction_Fraction,282,29,292,10,0,4,31,2,0,0,293,11,2,3,31,2,0,0,292,10,0,4,31,2,0,0
Math/92,src_java_org_apache_commons_math_util_MathUtils,557,50,617,60,0,0,54,4,0,0,601,44,8,16,52,2,0,2,614,57,9,3,54,4,0,0
Math/93,src_java_org_apache_commons_math_util_MathUtils,573,50,613,40,0,0,54,4,0,0,609,36,4,4,54,4,0,0,613,40,3,0,54,4,0,0
Math/94,src_java_org_apache_commons_math_util_MathUtils,570,51,615,45,0,0,53,2,0,0,610,40,3,5,53,2,0,0,612,42,1,3,53,2,0,0
Math/95,src_java_org_apache_commons_math_distribution_FDistributionImpl,76,12,91,15,0,0,14,2,0,0,91,15,0,0,14,2,0,0,90,14,0,1,14,2,0,0
Math/96,src_java_org_apache_commons_math_complex_Complex,265,36,296,31,1,0,38,2,0,0,292,27,0,4,38,2,0,0,291,26,0,5,38,2,0,0
Math/97,src_java_org_apache_commons_math_analysis_BrentSolver,123,4,148,25,0,0,6,2,0,0,144,21,7,4,6,2,0,0,144,21,3,4,6,2,0,0
Math/98,src_java_org_apache_commons_math_linear_BigMatrixImpl,911,70,936,25,0,0,72,2,0,0,933,22,0,3,72,2,0,0,936,25,0,0,72,2,0,0
Math/98,src_java_org_apache_commons_math_linear_RealMatrixImpl,744,52,770,26,0,0,54,2,0,0,767,23,0,3,54,2,0,0,770,26,0,0,54,2,0,0
Math/99,src_java_org_apache_commons_math_util_MathUtils,625,52,681,56,0,0,55,3,0,0,677,52,0,4,55,3,0,0,681,56,0,0,55,3,0,0
Mockito/1,src_org_mockito_internal_invocation_InvocationMatcher,120,17,142,22,0,0,19,2,0,0,142,22,1,0,19,2,0,0,141,21,0,1,19,2,0,0
Mockito/10,src_org_mockito_internal_stubbing_defaultanswers_ReturnsDeepStubs,89,19,122,33,0,0,23,4,0,0,120,31,2,2,23,4,0,0,120,31,2,2,23,4,0,0
Mockito/11,src_org_mockito_internal_creation_DelegatingMethod,41,9,58,17,0,0,12,3,0,0,57,16,1,1,12,3,0,0,52,11,1,6,11,2,0,1
Mockito/12,src_org_mockito_internal_util_reflection_GenericMaster,0,0,15,15,0,0,2,2,0,0,15,15,0,0,2,2,0,0,15,15,0,0,2,2,0,0
Mockito/13,src_org_mockito_internal_MockHandler,39,12,76,37,0,0,14,2,0,0,76,37,0,0,14,2,0,0,76,37,0,0,14,2,0,0
Mockito/14,src_org_mockito_internal_MockHandler,39,12,73,34,0,0,14,2,0,0,72,33,1,1,14,2,0,0,72,33,1,1,14,2,0,0
Mockito/14,src_org_mockito_internal_MockitoCore,131,16,151,20,0,0,18,2,0,0,151,20,0,0,18,2,0,0,150,19,0,1,18,2,0,0
Mockito/15,src_org_mockito_internal_configuration_injection_FinalMockCandidateFilter,5,1,31,26,0,0,4,3,0,0,30,25,1,1,4,3,0,0,30,25,1,1,4,3,0,0
Mockito/16,src_org_mockito_Mockito,197,32,219,22,0,0,35,3,0,0,216,19,0,3,35,3,0,0,219,22,0,0,35,3,0,0
Mockito/16,src_org_mockito_internal_MockitoCore,125,15,140,15,0,0,17,2,0,0,133,8,7,7,16,1,1,1,133,8,7,7,16,1,1,1
Mockito/17,src_org_mockito_internal_creation_MockSettingsImpl,66,15,78,12,0,3,18,3,0,0,79,13,3,2,18,3,0,0,71,5,0,10,16,1,0,2
Mockito/17,src_org_mockito_internal_util_MockUtil,64,9,90,26,0,0,11,2,0,0,90,26,0,0,11,2,0,0,90,26,0,0,11,2,0,0
Mockito/18,src_org_mockito_internal_stubbing_defaultanswers_ReturnsEmptyValues,19,4,72,53,0,0,6,2,0,0,72,53,0,0,6,2,0,0,71,52,2,1,6,2,0,0
Mockito/19,src_org_mockito_internal_configuration_injection_PropertyAndSetterInjection,59,7,81,22,0,0,9,2,0,0,81,22,0,0,9,2,0,0,81,22,0,0,9,2,0,0
Mockito/19,src_org_mockito_internal_configuration_injection_filter_FinalMockCandidateFilter,17,2,33,16,0,0,4,2,0,0,33,16,0,0,4,2,0,0,33,16,0,0,4,2,0,0
Mockito/19,src_org_mockito_internal_configuration_injection_filter_MockCandidateFilter,0,0,8,8,0,1,2,2,0,0,9,9,0,0,2,2,0,0,9,9,0,0,2,2,0,0
Mockito/19,src_org_mockito_internal_configuration_injection_filter_NameBasedCandidateFilter,5,3,26,21,0,0,5,2,0,0,26,21,0,0,5,2,0,0,26,21,0,0,5,2,0,0
Mockito/19,src_org_mockito_internal_configuration_injection_filter_TypeBasedCandidateFilter,5,2,23,18,0,0,4,2,0,0,23,18,0,0,4,2,0,0,23,18,0,0,4,2,0,0
Mockito/2,src_org_mockito_internal_util_Timer,11,4,19,8,0,0,6,2,0,0,19,8,0,0,6,2,0,0,19,8,0,0,6,2,0,0
Mockito/20,src_org_mockito_internal_creation_bytebuddy_ByteBuddyMockMaker,67,10,96,29,0,0,12,2,0,0,96,29,0,0,12,2,0,0,96,29,0,0,12,2,0,0
Mockito/21,src_org_mockito_internal_creation_instance_ConstructorInstantiator,26,4,51,25,0,8,7,3,0,0,58,32,5,1,7,3,0,0,53,27,1,6,7,3,0,0
Mockito/22,src_org_mockito_internal_matchers_Equality,31,4,49,18,0,0,6,2,0,0,49,18,0,0,6,2,0,0,49,18,0,0,6,2,0,0
Mockito/23,src_org_mockito_internal_stubbing_defaultanswers_ReturnsDeepStubs,48,7,82,34,0,1,13,6,0,0,83,35,0,0,13,6,0,0,83,35,2,0,11,4,0,2
Mockito/24,src_org_mockito_internal_stubbing_defaultanswers_ReturnsEmptyValues,50,4,73,23,0,0,6,2,0,0,73,23,0,0,6,2,0,0,72,22,0,1,6,2,0,0
Mockito/25,src_org_mockito_internal_stubbing_defaultanswers_ReturnsDeepStubs,14,4,53,39,0,0,8,4,0,0,50,36,14,3,8,4,0,0,50,36,1,3,8,4,0,0
Mockito/26,src_org_mockito_internal_util_Primitives,34,8,66,32,0,0,9,1,0,0,66,32,0,0,9,1,0,0,66,32,0,0,9,1,0,0
Mockito/27,src_org_mockito_internal_util_MockUtil,91,10,104,13,0,0,12,2,0,0,104,13,4,0,12,2,0,0,103,12,1,1,12,2,0,0
Mockito/28,src_org_mockito_internal_configuration_DefaultInjectionEngine,44,5,57,13,0,0,7,2,0,0,57,13,0,0,7,2,0,0,57,13,1,0,7,2,0,0
Mockito/29,src_org_mockito_internal_matchers_Same,22,5,36,14,0,0,7,2,0,0,36,14,0,0,7,2,0,0,36,14,0,0,7,2,0,0
Mockito/3,src_org_mockito_internal_invocation_InvocationMatcher,103,15,138,35,1,1,17,2,0,0,135,32,8,4,17,2,0,0,138,35,1,1,17,2,0,0
Mockito/30,src_org_mockito_exceptions_Reporter,331,49,340,9,0,0,51,2,0,0,332,1,2,8,50,1,0,1,340,9,0,0,51,2,0,0
Mockito/30,src_org_mockito_internal_stubbing_defaultanswers_ReturnsSmartNulls,26,7,48,22,0,0,10,3,0,0,48,22,0,0,10,3,0,0,48,22,0,0,10,3,0,0
Mockito/31,src_org_mockito_internal_stubbing_defaultanswers_ReturnsSmartNulls,34,7,48,14,0,0,10,3,0,0,48,14,0,0,10,3,0,0,48,14,0,0,10,3,0,0
Mockito/32,src_org_mockito_internal_configuration_SpyAnnotationEngine,18,2,56,38,0,0,4,2,0,0,54,36,1,2,4,2,0,0,56,38,3,0,4,2,0,0
Mockito/33,src_org_mockito_internal_invocation_InvocationMatcher,102,16,118,16,0,0,18,2,0,0,117,15,4,1,18,2,0,0,118,16,2,0,18,2,0,0
Mockito/34,src_org_mockito_internal_invocation_InvocationMatcher,85,15,106,21,0,0,17,2,0,0,106,21,0,0,17,2,0,0,106,21,0,0,17,2,0,0
Mockito/35,src_org_mockito_Matchers,313,47,346,33,0,0,51,4,0,0,343,30,0,3,51,4,0,0,346,33,0,0,51,4,0,0
Mockito/36,src_org_mockito_internal_invocation_Invocation,205,39,218,13,0,0,41,2,0,0,218,13,0,0,41,2,0,0,218,13,0,0,41,2,0,0
Mockito/37,src_org_mockito_internal_stubbing_answers_AnswersValidator,40,4,58,18,0,0,6,2,0,0,58,18,0,0,6,2,0,0,58,18,0,0,6,2,0,0
Mockito/38,src_org_mockito_internal_verification_argumentmatching_ArgumentMatchingTool,29,2,41,12,0,0,4,2,0,0,41,12,0,0,4,2,0,0,41,12,0,0,4,2,0,0
Mockito/4,src_org_mockito_exceptions_Reporter,481,71,507,26,0,0,75,4,0,0,504,23,0,3,75,4,0,0,507,26,0,0,75,4,0,0
Mockito/5,src_org_mockito_internal_verification_VerificationOverTimeImpl,62,13,90,28,0,0,15,2,0,0,90,28,0,0,15,2,0,0,90,28,0,0,15,2,0,0
Mockito/6,src_org_mockito_Matchers,237,34,375,138,0,0,55,21,0,0,320,83,13,55,47,13,0,8,371,134,7,4,55,21,0,0
Mockito/7,src_org_mockito_internal_util_reflection_GenericMetadataSupport,434,67,451,17,0,0,70,3,0,0,447,13,0,4,70,3,0,0,451,17,0,0,70,3,0,0
Mockito/8,src_org_mockito_internal_util_reflection_GenericMetadataSupport,426,68,450,24,0,0,70,2,0,0,446,20,0,4,70,2,0,0,450,24,0,0,70,2,0,0
Mockito/9,src_org_mockito_internal_stubbing_answers_CallsRealMethods,0,1,10,10,0,0,3,2,0,0,10,10,0,0,3,2,0,0,10,10,0,0,3,2,0,0
Time/1,src_main_java_org_joda_time_Partial,455,53,525,70,0,0,55,2,0,0,521,66,0,4,55,2,0,0,525,70,0,0,55,2,0,0
Time/1,src_main_java_org_joda_time_field_UnsupportedDurationField,166,27,178,12,0,0,29,2,0,0,178,12,0,0,29,2,0,0,178,12,0,0,29,2,0,0
Time/10,src_main_java_org_joda_time_base_BaseSingleFieldPeriod,150,19,180,30,0,0,21,2,0,0,180,30,0,0,21,2,0,0,180,30,0,0,21,2,0,0
Time/11,src_main_java_org_joda_time_tz_ZoneInfoCompiler,654,64,657,3,0,0,66,2,0,0,654,0,0,3,66,2,0,0,657,3,0,0,66,2,0,0
Time/12,src_main_java_org_joda_time_LocalDate,876,125,914,38,0,0,128,3,0,0,910,34,0,4,128,3,0,0,913,37,0,1,128,3,0,0
Time/12,src_main_java_org_joda_time_LocalDateTime,1006,145,1036,30,0,0,148,3,0,0,1032,26,0,4,148,3,0,0,1035,29,0,1,148,3,0,0
Time/13,src_main_java_org_joda_time_format_PeriodFormatterBuilder,1382,158,1452,70,0,0,162,4,0,0,1446,64,0,6,162,4,0,0,1452,70,0,0,162,4,0,0
Time/14,src_main_java_org_joda_time_chrono_BasicMonthOfYearDateTimeField,200,22,224,24,0,0,24,2,0,0,222,22,0,2,24,2,0,0,224,24,0,0,24,2,0,0
Time/15,src_main_java_org_joda_time_field_FieldUtils,183,15,205,22,0,0,17,2,0,0,202,19,0,3,17,2,0,0,205,22,0,0,17,2,0,0
Time/16,src_main_java_org_joda_time_format_DateTimeFormatter,439,52,473,34,0,0,54,2,0,0,470,31,1,3,54,2,0,0,472,33,2,1,54,2,0,0
Time/17,src_main_java_org_joda_time_DateTimeZone,704,67,729,25,0,0,69,2,0,0,716,12,0,13,68,1,0,1,728,24,4,1,69,2,0,0
Time/18,src_main_java_org_joda_time_chrono_GJChronology,813,94,843,30,0,0,96,2,0,0,839,26,0,4,96,2,0,0,843,30,0,0,96,2,0,0
Time/19,src_main_java_org_joda_time_DateTimeZone,689,67,726,37,0,0,69,2,0,0,722,33,0,4,69,2,0,0,726,37,0,0,69,2,0,0
Time/2,src_main_java_org_joda_time_Partial,402,52,522,120,0,0,55,3,0,0,518,116,0,4,55,3,0,0,522,120,0,0,55,3,0,0
Time/2,src_main_java_org_joda_time_field_UnsupportedDurationField,166,27,178,12,0,0,29,2,0,0,178,12,0,0,29,2,0,0,178,12,0,0,29,2,0,0
Time/20,src_main_java_org_joda_time_format_DateTimeFormatterBuilder,2427,224,2453,26,0,0,227,3,0,0,2444,17,8,9,227,3,0,0,2449,22,6,4,227,3,0,0
Time/22,src_main_java_org_joda_time_base_BasePeriod,367,34,378,11,0,0,36,2,0,0,371,4,0,7,35,1,0,1,375,8,0,3,35,1,0,1
Time/23,src_main_java_org_joda_time_DateTimeZone,671,67,724,53,9,8,69,2,0,0,716,45,6,16,69,2,0,0,720,49,18,12,69,2,0,0
Time/24,src_main_java_org_joda_time_format_DateTimeParserBucket,251,48,301,50,0,0,50,2,0,0,298,47,0,3,50,2,0,0,301,50,0,0,50,2,0,0
Time/25,src_main_java_org_joda_time_DateTimeZone,675,66,701,26,0,0,68,2,0,0,697,22,0,4,68,2,0,0,701,26,0,0,68,2,0,0
Time/27,src_main_java_org_joda_time_format_PeriodFormatterBuilder,1419,160,1449,30,0,0,162,2,0,0,1446,27,0,3,162,2,0,0,1449,30,0,0,162,2,0,0
Time/3,src_main_java_org_joda_time_MutableDateTime,663,106,734,71,0,0,117,11,0,0,722,59,9,12,117,11,0,0,725,62,9,9,117,11,0,0
Time/4,src_main_java_org_joda_time_Partial,464,53,521,57,0,0,55,2,0,0,517,53,0,4,55,2,0,0,521,57,0,0,55,2,0,0
Time/5,src_main_java_org_joda_time_Period,707,87,738,31,0,2,89,2,0,0,728,21,22,12,89,2,0,0,732,25,11,8,89,2,0,0
Time/6,src_main_java_org_joda_time_chrono_GJChronology,769,91,862,93,0,0,96,5,0,0,858,89,0,4,96,5,0,0,861,92,0,1,96,5,0,0
Time/7,src_main_java_org_joda_time_format_DateTimeFormatter,439,52,476,37,0,0,54,2,0,0,470,31,0,6,54,2,0,0,473,34,0,3,54,2,0,0
Time/8,src_main_java_org_joda_time_DateTimeZone,706,68,746,40,0,0,70,2,0,0,742,36,0,4,70,2,0,0,742,36,3,4,70,2,0,0
Time/9,src_main_java_org_joda_time_DateTimeZone,695,66,744,49,0,0,69,3,0,0,740,45,0,4,69,3,0,0,734,39,0,10,69,3,0,0
